Do you know how long before my order ships 	I do not know how long before your order ships	A23CTGXNDDW5LC	
How can I load paper into my HR-8 series calculator 	I do not know how you can load paper into your HR-8 series calculator 	A13GUTDMGGZZDL
Do you have any job openings 	I do not know if we have any job openings 	A3VV5FFG6GXE1S	
What do whales eat 	I do not know what whales eat 	A1J0GU26323WVA
I am legally resident in Northern Ireland , where can I apply for an Irish visa 	I do not know where you can apply for an Irish visa 	A2VIN0EE9BGPSH
What is the capacity for an event 	I do not know the capacity for an event 	A1JBSFXMMRGSQD
Can I get a new debit card 	I do not know if you can get a new debit card 	A325WS381BHOHH	
May an employee change his or her flexible spending account -LRB- FSA -RRB- elections midyear 	I do not know if an employee can change his or her flexible spending account -LRB- FSA -RRB- elections midyear 	A8O98QNRG9SHV
If I find out a pair of shoes hurt my feet after wearing them for a while , can I still return them 	I do not know if you are able to return a pair of shoes you find hurt your feet after wearing them for a while 	A3SSJNH5SIZUPG	
Why ca n't I take photos in the Feature Gallery 	I do not know why you ca n't take photos in the Feature Gallery 	A3G2FBKYCRD5Q8
How can I check if my payment is past due 	I do not know how you can check if your payment is past due	A23CTGXNDDW5LC	
How is Amazon S3 data organized 	I do not know how Amazon S3 data is organized	A16184N1RO5OJV
If registered domestic partners adopt a child together , can one or both of the registered domestic partners qualify for the adoption credit 	I do not know if they can qualify for the adoption credit 	A13GUTDMGGZZDL
Can I become a certified user without a California DMV license 	I do not know if you can become a certified user without a California DMV license 	A1S8DYWNS59XWB
Can I reproduce works from BAMPFA exhibitions and collections 	I do not know if you can reproduce works 	A13GUTDMGGZZDL
Could you tell me what your mailing address is please 	I do not know what our mailing address is 	A9LX66EQWDRQ5	
Are there special limits in running credit checks on independent contractors 	I do not know if there are special limits 	A13GUTDMGGZZDL
What is your fax number 	I do not know our fax number 	APC99TPURUHR8
Can I take dance classes in other areas that are not in my concentration 	I do not know you can take dance classes in other areas that are not in my concentration	A16184N1RO5OJV
May an employer give cash advances to employees for transportation costs 	I do not know if an employer may give cash advances to employees for transportation costs 	A1J0GU26323WVA
Do you sell an Nissan Sentras 	I do not know if we sell any Nissan Sentras 	A3VV5FFG6GXE1S	
When I register a domain , do I receive a website and a web hosting space 	I do not know if you receive a website and a web hosting space when you register a domain 	A1J0GU26323WVA
What programs do you offer 	I do not know what programs we offer 	A3SS1F4F3JE7CU
Who informs the candidate of disqualifying background check results 	I do not know who informs candidates of disqualifying background checks 	A1F46RJTOXQM4J
Can crabs swim 	I do not know if crabs can swim 	A1JBSFXMMRGSQD
Is a discount available for groups 	I do not know if a discount is available 	A2NI2HSU84PHJW
May I use images designated as CC0 in a lecture , or for other educational purposes 	I do not know if you may use images designated as CC0 in a lecture , or for other educational purposes 	A16VTK6KZ1U69H
Are you able to ship outside the United States 	I do not know if we are able to ship outside the United States 	A31A4YKVSOYRVS	
Is there an age limit for this event 	I do not know if there is an age limit for this event 	A3NZLRU95OULXB
Will I receive a refund for any cancelled camps 	I do not know if you will receive a refund for any cancelled camps 	A2HKTM4Z8652
What happens if I am picking up my ticket at will call 	I do not know what happens if you are picking up your ticket at will call 	A3R71HP45TBQ7O
Can DACA recipients whose valid EAD is lost , stolen or destroyed request a new EAD during the phase out 	I do not know if DACA recipients whose valid EAD has been lost , stolen or destroyed can request a new EAD during the phase out 	ABN6GDFW4N8AK
Do I have to pay each year to renew my HEVC license like some vendors 	I do not know if you have to pay each year to renew your HEVC license 	A9LX66EQWDRQ5
How can our class best respect the animals 	I do not know how your class can best respect the animals 	A2EJ7U3TZAKROG
If I want 2018 Marketplace health coverage , when 's my enrollment deadline 	I do not know the enrollment deadline 	A2NI2HSU84PHJW
I would like to learn more about places to eat	I do not know of more places to eat 	APC99TPURUHR8
How do I sign up for direct deposit 	I do not know how you sign up for direct deposit 	A3R71HP45TBQ7O
I am a tourist visiting from Manhattan . What 's the easiest way to get to the zoo	I am not able to tell you what the easiest way to get to the zoo is 	A2I4VNAS21FXCE
What if I forget my password for My Verizon 	I do not know what you should do if you forget your password 	A13GUTDMGGZZDL
I want to cancel my policy 	I am not able to cancel your policy	A23CTGXNDDW5LC
How long is kitchen craft 's Warranty	I do not know how long Kitchen Craft 's warranty lasts 	A1JBSFXMMRGSQD
Please correct my email address 	I am not able to correct your email address 	A3GNQDFPZALU92	
Are there any of your stores in my town 	I do not know if there are any of our stores in your town	A23CTGXNDDW5LC
Where do I go if I think I am in labor 	I do not know where you go if you think you 're in labor 	A2NI2HSU84PHJW
Where does the train go , and how long is the ride 	I do not know where the train goes , nor how the long the ride is 	A3R71HP45TBQ7O
Can I use the menu app	I do not know if you can use the menu app 	A3GNQDFPZALU92	
Why can the system build such a profile , or what is the scientific foundation of it 	I do not know why the system builds such a profile or the scientific foundation of it 	A2K9PB0U45O0MU
I need to cancel a payment 	I am not able to cancel a payment 	A1YKWG46AWMPUX	
When does the free trial end 	I do not know when the free trial ends 	A325WS381BHOHH	
When I assign or sell a lease or retail installment contract to a third party lender , do I have to give an opt-out notice to my customers 	I do not know if you have to give an opt-out notice to your customers 	A2NI2HSU84PHJW
What functions will be in the new courthouse 	I do not know what functions will be in the new courthouse 	AE9M4Z1NCYSDM
Can you mail merge documents 	I do not know if you can mail merge documents 	A1JBSFXMMRGSQD
What payment types does the Van Gogh Museum online store accept 	I do not know what payment types the Van Gogh Museum online store accepts 	A2NI2HSU84PHJW
I forgot my user ID and/or password , what do I do 	I do not know what you do	A23CTGXNDDW5LC
Do you accept returned items 	I do not know if we accept returned items	A23CTGXNDDW5LC	
How do I cancel my monthly subscription service 	I do not know how to cancel your subscription 	A1HQRT1UG6ERGL
If I received an item as a gift , how should I return it	I do not know how to return a gift item 	AJKA9BKC011F2
Will you accept orders to Canada 	I am not able to accept orders to Canada 	A3RD486RQUI2XV
What can I do about hang up calls 	I do not know what you can do about hang up calls 	A1JBSFXMMRGSQD
What facilities are available for guests with disabilities 	I do not know what facilities are available for guests with disabilities 	AJ7E01X4TAGHL
Will media from this site install correctly on a device that came with an operating system pre-installed 	I do not know if media from the site will install correctly on a device that came with an operating system pre-installed 	A2TP3K1THK6XRB
When did Neil Armstrong die 	I do not know when Neil Armstrong died 	A13GUTDMGGZZDL
Can I pay directly through my bank account 	I do not know if you can pay directly through your bank account 	A325WS381BHOHH	
Can I change my coverage during the year 	I do not know if you can change your coverage 	A13GUTDMGGZZDL
What 's your refund policy 	I do not know the refund policy 	AE9M4Z1NCYSDM	
Where do harbor porpoises live 	I do not know where harbor porpoises live 	A1S8DYWNS59XWB
What is the difference between the All Item tab and the Item Shipped by Newegg tab in Item List function 	I do not know what the differences is between the all item tab and the Item Shipped tab	APF1EAZT104LQ
Do you offer discount to NHS staff , the Armed forces or local residents 	I do not know if we offer discounts to NHS staff , the Armed forces or local residents 	A2K9PB0U45O0MU
What happens if I return a pass late 	I do not know what happens if you return a pass late 	A2NI2HSU84PHJW
Can I buy a flight ticket from a self-service check-in machine at the airport 	I do not know if you can buy a flight ticket from a self-service check-in machine 	A1XNCA1SVTT15B
Are there nearby places for a quick lunch 	I do not know if there are nearby places for a quick lunch	A1GNG0J27JYSUB
What is global warming , and how is it different from climate change and climate variability 	I do not know what global warming is or how it is different from climate change 	A13GUTDMGGZZDL
Must an employee earning below the minimum salary level for determining exempt status under the Fair Labor Standards Act be converted to hourly pay 	I do not know if an employee earning below the minimum salary level for determining exempt status under the Fair Labor Standards Act be converted to hourly pay 	A3I9FTHSULHPYS
Will this order include sales tax 	I do not know if this order will include sales tax 	A31A4YKVSOYRVS	
What is included in the price of a closet 	I do not know what is included in the price of a closet 	A2TP3K1THK6XRB
I 'm having difficulty signing up . Whom can I contact 	I do not know who you can contact about your difficulty signing up 	A1IPD4WBT3A5GG
Who can I speak to about the customer service I 've received 	I do not know who you can speak to about customer service you received 	AJNQ2PBD07FKE
What is the cost for shipping the items 	I do not know what the cost for shipping the items is 	A325WS381BHOHH	
When can I use Backup Care Options 	I do not know when you can use Backup Care Options 	A2K2MFQMN31DZ
Does EDDA have any outreach programs 	I do not know if EDDA has any outreach programs 	APC99TPURUHR8
What time will my order arrive 	I do not know what time your order will arrive 	A185P3B2MC2K83
How should I clean my Staub products 	I do not know how you should clean your Staub products 	A9LX66EQWDRQ5
Why should I add a photo to my membership record 	I do not know why you should add a photo 	A13GUTDMGGZZDL
As a senior citizen -LRB- age 62 or older -RRB- , am I eligible for any discount 	I do not know if you are eligible for any discount 	A7SXWHGK8B40R
How do I search and apply for jobs 	I do not know how to search and apply for jobs 	A2K9PB0U45O0MU
Can I pick up my package at the shipping facility 	I do not know if you can pick up your package at the shipping facility 	A9LX66EQWDRQ5	
What will I/my child need for class	I do not know what you or your child need for class 	A30YFEIPGXNWJL
What does ' billing address country ' mean 	I do not know what billing address country means 	A7SXWHGK8B40R
Can a taxpayer use the head-of-household filing status if the taxpayer 's only dependent is his or her registered domestic partner 	I do not know if a taxpayer can use head-of-household filing status if the taxpayer 's only dependent is his or her registered domestic partner 	A1JBSFXMMRGSQD
What is your full postal address , so I can type this in to my SAT NAV system 	I do not know our full postal address 	A16NITTBMCSN0V
Does the museum allow artists to sketch or paint in the galleries 	I do not know if the museum allows artist to sketch or paint in the galleries 	A7SXWHGK8B40R
My order says it was delivered but I have not received it , why 	I do not know why you have not received your order 	AD9O852KPYLHY	
Is ' Prometheus ' based on a book 	I do not know if ' Prometheus ' is based on a book 	A3I9FTHSULHPYS
I paid for admission to the Zoo , can I apply the cost towards a membership 	I am not able to apply the cost of your admission toward a membership at the Zoo 	A234VIHHUHPZG5
How do I identify the model number of a slide	I am not able to identify the model number of a slide 	A2LQ9NP944M61Z
Why do some of your products contain foreign honey 	I do not know why some of our products contain foreign honey 	A3SS1F4F3JE7CU
What options are available for a payment plan 	I do not know what options are available for a payment plan 	AJQGWGESKQT4Y
What is DivX Certified Device Registration 	I do not know what the DivX Certified Device Registration is 	A2K2MFQMN31DZ
What is a TCRG	I do not know what a TCRG is 	A13GUTDMGGZZDL
What does the Museum do to support teachers 	I do not know what the museum does to support teachers 	A1X3SF2W1QQBY1
My order is wrong 	I do not know why your order is wrong 	A1YKWG46AWMPUX	
Can you help me exchange this product for another in your store 	I am not able to help you excange the product for another 	A263D0NONXWQID
Can I use my nickname instead of my legal name for travel 	I do not know if you can use your nickname instead of your legal name for travel 	A398I2WV28FA5P	
Can you tell me when my order will be shipped 	I am not able to tell you when your order will be shipped 	A3U6CLX7HD0SMF	
I noticed there is a charge for an item I did not purchase 	I do not know why there is a charge for an item that you did not purchase 	A9LX66EQWDRQ5	
Do you sell this couch in brown 	I do not know if we sell this couch in brown 	A3VV5FFG6GXE1S	
My registration renewal is due but my car is under repair and I ca n't get a smog check 	I am not able to tell you why you ca n't get a smog check 	AU3WB2DD4QJ4B
Can I get the cake made without gluten 	I do not know if you can get the cake made without gluten 	A325WS381BHOHH	
Can the local authority use the services of another local authority to undertake its zoo licensing activities 	I do not know if local authority can use services of another local authority to undertak its zoo licensing activities 	A3EJ2U51X7CLYW
What administrative fees may an employer charge for a garnishment or child support order 	I do not know what the administrative fees are	APF1EAZT104LQ
Can I schedule a maintenance appointment 	I do not know if you can schedule a maintenance appointment 	AGQPTDG6ZF3T3
How do I get to the Dakota Zoo 	I am not able to tell you how to get to the Dakota Zoo 	A116N2LEI6O7HB
What does it mean to ' give notice ' to the other party 	I do not know what it means to give notice to the other party	APF1EAZT104LQ
I will not be home for delivery . Can you re-route the package to a different address 	I do not know if we can re-route the package to a different address 	AD9O852KPYLHY	
A 10 % off coupon was supposed to be applied to my order but I just received my bill and it was not applied 	I am not able to apply a 10 % off coupon to your order 	A9LX66EQWDRQ5	
Can a hospice patient who shows signs of recovery be returned to regular medical treatment 	I do not know if a hospice patient who shows signs of recovery can be returned to regular medical treatment 	A2VIKCIM9TZL22
Are interviews required 	I do not know if interviews are required 	A1F46RJTOXQM4J
I would like some help about an item I saw on your website 	I am not able to help with an item you saw on our website 	ASFR82SJYMGNU
How do I choose a class that is right for me 	I do not know how you would choose a class that is right for you 	A2K2MFQMN31DZ
Can CIBTvisas obtain additional passport pages for my US passport 	I do not know if CIBTvisas obtains additional passport pages for your passport 	A2NI2HSU84PHJW
What if I want to visit another Arab country 	I do not know if you want to visit another arab country 	A2K9PB0U45O0MU
How do I reset my current voicemail password 	I do not know how you reset your current voicemail password 	A2HKTM4Z8652
Can I include a gift message 	I do not know if you can include a gift message 	A2LQ9NP944M61Z
Who gets to choreograph 	I do not know who gets to choreograph 	A3I9FTHSULHPYS
Will there be food options 	I do not know if there will be food options 	AQ9Y6WD8O72ZC
I have a Drug Enforcement Administration -LRB- DEA -RRB- Number . Do I need a National Provider Identifier -LRB- NPI -RRB- as well 	I do not know if you need a NPI as well 	A2NI2HSU84PHJW
What bus route services the Zoo 	I do not know which bus route services the Zoo 	A21EPR8KW0GWX2
What is wearable technology 	I do not know what wearable technology is 	A3I9FTHSULHPYS
Do current or former employees have a right to access their personnel records in order to inspect , copy or dispute the information 	I am not able to tell you if current or former employees have a right to access their personnel records 	A1A0PNOBFTTHGP
Will the Museum still be a ' curio cabinet ' 	I do not know if the Museum will still be a ' curio cabinet . '	A14M2EERU7E8KD
What is MobileIron 	I do not know what MobileIron is	ATQD23E8ESFSI
Will I be notified and reaccommodated if my flight changes or is canceled after I check in at united.com 	I do not know if you will be notified and reaccommodated if your flight changes or is canceled after you check in at united.com 	A1JBSFXMMRGSQD
What is the volunteer commitment 	I do not know what the volunteer commitment is 	ARKAJ6PL85CME
What are honey 's nutrition facts 	I do not know honey 's nutrition facts 	A10249252O9I20MRSOBVF
How do I put a rush on my claim 	I do not know how you can put a rush on your claim 	AD9O852KPYLHY	
I wo n't be able to pick up my order until tomorrow , but I scheduled it for pickup today . Can we change this 	I am not able to change your order schedule 	AKQ23WWJ57B8R	
How do we pay 	I do not know how you pay 	A2HKTM4Z8652
At what age can children visit the park without an adult 	I do not know at what age children can visit the park without an adult 	A3U0VQ420HIMQ0
Why ca n't I select ground shipping for my order 	I do not know why you ca n't select ground shipping for your order 	A2HKTM4Z8652
Can pupils under 11 years old also follow an educational programme 	I do not know if pupils under eleven years old can follow an educational programe 	A3SS1F4F3JE7CU
Can ESS be viewed by people who have left the University 	I do not know if ESS can be viewed by people who have left the University 	AFS36YMNN8A2J
What time will the delivery driver get here 	I do not know what time the delivery driver will get there 	A2CEGV4ZIZWRKY	
What is an MPOP ™ 	I do not know what an MPOP is 	AFK0MM5DQUUG5
How many people were registered as prisoners in Auschwitz 	I do not know how many people were registered as prisoners in Auschwitz 	A1A0PNOBFTTHGP
What is the International Spy Museum 	I do not know what the International Spy Museum is 	A2NI2HSU84PHJW
Will the application work if I update ZOO or Joomla 	I do not know the application will work if you update Zoo or Joomla 	A2VIN0EE9BGPSH
What is the Congressional Record 	I do not know What the Congressional Record IS	ATQD23E8ESFSI
I believe my product was lost during shipment , I want to get my money back 	I am not able to get your money back 	A185P3B2MC2K83
Do you offer refunds 	I do not know if we offer refunds 	AZLZA0Q87TJZO
Is there a fee for cancelling early 	I do not know if there is a fee for cancelling early 	A3GNQDFPZALU92	
How long may I wait if I need to speak to human 	I do not know how long you wait if you need to speak to human 	A1GAARR4GOOZCO	
What should I wear in the adult classes 	I do not know what you should wear in the adult classes 	A2K2MFQMN31DZ
Where does the film 's title come from 	I do not know where the film 's title comes from 	A9LX66EQWDRQ5
Can I get a star named after me and claim copyright to it 	I do not know if you can get a star named after you and claim copyright to it 	A1WRD2K9USCOAV
How much will I get paid 	I do not know how much you will get paid 	A2K2MFQMN31DZ
What holidays are observed at the University 	I do not know what holidays are observed at the University 	A27MJOV91GA8R3
Why do brown specks form on the base of my roasting pan 	I do not know why brown specks form on the base of a roasting pan 	A2K9PB0U45O0MU
Which membership type would best fit my situation	I do not know which membership type would best fit your situation 	A1JBSFXMMRGSQD
How can I help spread the word 	I do not know how you can help spread the word 	A11IEP7J8XSE1C
I see movies and TV shows available on my retailer 's website for purchase that are not listed as UltraViolet . Why 	I do not know why those movies are not on UltraViolet	APF1EAZT104LQ
What days are you open 	I do not know what days we are open 	AZLZA0Q87TJZO
How do I renew my membership 	I do not know how you renew your membership 	A3I9FTHSULHPYS
How are classes paid 	I do not know how classes are paid	A23CTGXNDDW5LC
Do you offer free shipping 	I do not know if we offer free shipping 	A1JBSFXMMRGSQD
How many different shipping options are there 	I do not know how many different shipping options there are 	A31A4YKVSOYRVS	
If I am not a united.com Club member and I purchase the ticket for someone who is a united.com Club member , do they get the credit 	I do not know if they get credit 	A2NI2HSU84PHJW
What if I register late 	I do not know what happens if you register late 	AFS36YMNN8A2J
I need to make a claim for a lost package 	I am not able to help you make a claim 	AMW07CJC3OJIB
How do I sell tickets for my show 	I do not know how you sell tickets for your show 	A1X3SF2W1QQBY1
Is ' Doubt ' based on a book 	I do not know if ' Doubt ' is based on a book 	AZLZA0Q87TJZO
In the Headings List , why do some headings display without icons 	I do not know in the Headings List , why do some headings display without icons 	A3SS1F4F3JE7CU
Shipping in 2 days is guaranteed but does that include delivery on a weekend day 	I do not know if that includes delivery on a weekend day 	A31A4YKVSOYRVS	
What day will my package expect to ship 	I do not know what day your package will expect to ship 	A3GNQDFPZALU92	
Can I please change my method of payment for my order 	I am not able to change your method of payment for your order	A23CTGXNDDW5LC
What are the investments in the CSRDF that Treasury can redeem 	I do not know what investments in the CSDRF Treasury can redeem 	AISE949ZZN8HA
Do I need a receipt if I received this item as a gift 	I do not know if you need a receipt if you received the item as a gift 	A31A4YKVSOYRVS	
What does the HR Consulting Audit cover and what is its value 	I do not know what the HR Consulting Audit covers or its value 	A234VIHHUHPZG5
I just placed an order online but , I need to change it . Can you help me with that 	I am not able to help you with that	A23CTGXNDDW5LC	
Will there be any delays in my package 	I do not know if there will be delays in your package 	A1NDM9R54FJMPW	
What is the best way to setup an alert on the website 	I do not know how to setup an alert on the website 	A1GAARR4GOOZCO	
Where do I have to apply to get my visa 	I do not know where you have to apply to get your visa 	A7SXWHGK8B40R
Can you send me feathers or other items from an animal 	I am not able to send you feathers or other items from an animal 	A3RD486RQUI2XV
Who can I send my complaint to 	I do not know who you can send your complaint to 	AD9O852KPYLHY	
Can you help me place an order 	I am not able to help you place an order	A23CTGXNDDW5LC
Can you ship FedEx instead of USPS 	I do not know if I can ship FedEx instead of USPS 	A2EAJXBORHT44T	
Can I bring pets along on the tour 	I do not know if you can bring pets along on the tour 	A3RO0QIXW4IX3Y
Can you tell me what the difference between this model is and your most expensive model 	I am not able to tell you what the difference is between this model and our most expensive model 	A325WS381BHOHH	
Please send me tracking information	I am not able to sen you your tracking information 	A9LX66EQWDRQ5	
Can I make a public wishlist of items I like on your website	I do not know how to create a publish wishlist 	AEXWOFM1LGS6U
When will your holiday sale begin 	I do not know when our holiday sale begins 	A9LX66EQWDRQ5	
Can I pay for my purchase with two payment sources 	I do not know if you can pay for your purchase with two payment sources 	A3SSJNH5SIZUPG	
Do All CUMASCAIGH STUDENTS PARTICIPATE IN IRISH DANCING COMPETITIONS	I do not know if all Cumascaigh students participate in Irish dancing competitions	A3EMEMWJDM5DAR
What is your most popular product 	I do not know what product is our most popular 	A3SSJNH5SIZUPG	
Is it hard to keep all of the cars running	I do not know if it is hard 	A325WS381BHOHH
Can I delete my account or profile 	I do not know if you can delete your account or profile 	A3G2FBKYCRD5Q8
Where can I find forms that may be necessary when applying 	I do not know where you can find forms that may be necessary when applying 	A3RD486RQUI2XV
What is FDAAA 	I do not know what the FDAAA is 	A2VIKCIM9TZL22
How can I place an order using my tax exempt number 	I do not know how you can place an order using your tax exempt number 	A5VBIZ2KIQ1R8
My mom said I could order this x rated movie but the site wo n't let me	I am not able to help you order that x rated movie 	A325WS381BHOHH	
What sorts of products should I use for cooking 	I do not know which products 	A1DWQO9X2ZQ35G
Where is free parking available with my zoo membership	I do not know where free parking is available with your zoo membership	A23CTGXNDDW5LC
How big is a blue whale 	I do not know how big a blue whale is 	A2NI2HSU84PHJW
Can I book an educational programme in another language 	I do not know if you can book an educational programme in another language 	A3CL6GEDFNQGQY
Can a beginning child take a trial lesson or observe before enrolling 	I do not know if a beginning child can take a trial lesson or observe before enrolling 	A3NZLRU95OULXB
What 's the difference between an interstate and an intrastate CDL 	I do not know the difference between an interstate and an intrastate CDL 	A2VIKCIM9TZL22
Within how many minutes after placing an order can I cancel 	I do not know how many minutes after placing an order you can cancel 	A1CQPRZUT6BW44
Do you offer socks at wholesale 	I do not know if we offer socks at wholesale 	A13GUTDMGGZZDL
I need to report a wreck 	I am not able to report a wreck 	A31A4YKVSOYRVS	
Where do I start	I do not know where you should start 	A13GUTDMGGZZDL
Does the AACA Museum offer wheelchairs 	I do not know if the AACA Museum offers wheelchairs 	AZLZA0Q87TJZO
I need to transfer service to my new address 	I am not able to transfer service to your new address 	A3GNQDFPZALU92	
What effect does having my premiums taken out before or after taxes have on my choice to drop coverage 	I do not know what effect it has on your choice to drop coverage 	A13GUTDMGGZZDL
Will we be able to log into Workday through the college homepage 	I do not know if you will be able to 	A1DWQO9X2ZQ35G
Where can I find information on the new Quebec parental insurance plan 	I do not know where you can find information on the new Quebec parental insurance plan 	A1R1J3GL0YP7DJ
How can I pay for admission 	I do not know how you can pay for admission 	A13GUTDMGGZZDL
How does brown sugar differ from white sugar 	I do not know how brown sugar differs from white sugar 	A9LX66EQWDRQ5
Do you know what my 3 biggest transactions were 2 months ago 	I do not know what your 3 biggest transactions were 2 months ago 	A9LX66EQWDRQ5	
How can I be sure my online application was received 	I do not know if you can be sure if your online application was received 	AU3WB2DD4QJ4B
How much do you charge if I would like to locate a vehicle 	I do not know how much we charge to locate a vehicle 	A1XNCA1SVTT15B
Have there been any changes to my contract as a result of this merger 	I do not know if the merger resulted in any changes to your contract 	A30YFEIPGXNWJL
How can I get in contact with my teacher	I do not know how can you get in contact with your teacher 	A3SS1F4F3JE7CU
Where do I download the file to 	I do not know where you download the file to 	A16VTK6KZ1U69H
Would a person , travelling with me or my group , need not to buy the 72h or 48h Roma Pass Card , could he/she enter with me without lining up 	I am not able to tell you if a person , travelling with me or my group , need not to buy the 72h or 48h Roma Pass Card , could he/she enter with me without lining up 	A355BVFIOODRH2
Is there a lost and found 	I do not know if there is a lost and found 	A16NITTBMCSN0V
Can I pay my property tax bill online 	I do not know if you can pay your property tax bill online 	AE9M4Z1NCYSDM	
Do you offer discounts or price breaks 	I do not know if discounts or price breaks are offered 	A235UQRA8GE18X
What sort of souvenirs and gifts can I find 	I do not know what sort of souvenirs and gifts you can find 	A1JBSFXMMRGSQD
Should an employer seek a refund from the IRS of overwithheld income taxes due to a prior-year wage overpayment 	I do not know is an employer should seek a refund from the IRS of overwithheld income taxes due to a prior-year wage overpayment 	A2TP3K1THK6XRB
What days of the week and hours is the museum open 	I do not know what days of the week and hours is the museum open 	A3RD486RQUI2XV
Happy HR terms and conditions 	I do not know Happy HR terms and conditions 	A1J0GU26323WVA
Must a partnership or corporation file a tax return even though it had no income for the year 	I do not know if they need to file 	A1DWQO9X2ZQ35G
Please tell me what kind of free promotions you might have going on at the moment 	I am not able to tell you what kind of free promotions we might have going on at the moment	A23CTGXNDDW5LC
I lost my insurance card and need a new one	I am not able to replace your insurance card 	AXY0D2AMLKE2A
Is there any benefit to allowing employees to use wearable technology in the workplace 	I do not know if there is any benefit to allowing employees to use wearable technology in the workplace 	A9LX66EQWDRQ5
What is a private limited company 	I do not know what a private limited company is 	A13GUTDMGGZZDL
How many discounts can I use for one order 	I do not know how many discounts you can use for one order 	A9LX66EQWDRQ5	
How can I make a complaint 	I do not know how you can make a complaint	A23CTGXNDDW5LC
Who is eligible for Medicaid 	I do not know who is eligible for Medicaid 	A2K2MFQMN31DZ
When is Jazz incorporated to a child 's curriculum 	I do not know when Jazz is incorporated into a child 's curriculum 	A2TP3K1THK6XRB
Can I copyright my domain name 	I do not know if you can copyright your domain name 	A2NI2HSU84PHJW
What if I paid for tickets but did not receive an email or could not print my tickets 	I am not able to tell you what to do if you paid for tickets but did not receive an email or could not print your tickets 	A2UBEPT605E8T2
How can I get experience as a zookeeper 	I do not know how you can get experience as a zookeeper 	A2NI2HSU84PHJW
Do I also need to wait in line if I have a Museum Card 	I do not know if you need to wait in line if you have a museum card	APF1EAZT104LQ
How often is mileage information updated 	I do not know how often the mileage information is updated 	A7SXWHGK8B40R
I need a copy of my receipt please 	I am not able to give you a copy of your receipt 	A31A4YKVSOYRVS	
My bill amount is incorrect 	I am not able to help if your bill amount is incorrect 	AE9M4Z1NCYSDM	
Is the value of meals provided to an employee on the employer 's premises for the employer 's convenience or benefit taxable income to the employee 	I do not know if the value of meals provided to an employee on the employer 's premises for the employer 's convenience or benefit taxable income to the employee 	A3I9FTHSULHPYS
Do I need to purchase an extended warranty 	I do not know if you need to purchase an extended warranty 	A13GUTDMGGZZDL
How should I submit my letters of recommendation 	I do not know how you can submit your letters of recommendation 	A1J0GU26323WVA
Can you buy tickets online 	I do not know if you can buy tickets online 	A7SXWHGK8B40R
Are n't dance classes expensive 	I do not know if dance classes are expensive 	A27MJOV91GA8R3
Do you offer an initial consultation 	I do not know if we offer an initial consultation 	A2NI2HSU84PHJW
I am interested in upgrading my membership to a higher level . How should I do this 	I do not know how you upgrade your membership to a higher level 	A3RD486RQUI2XV
Where can I park when coming for a tour 	I do not know where you can park when coming for a tour 	A7SXWHGK8B40R
How can I purchase or renew a membership 	I do not know about the membership 	A3722NOMVUK89T
Where can I find support 	I do not know where you can find support 	A1J0GU26323WVA
What is your approval requirements on a loan 	I do not know our current loan approval requirements 	A2IY2RXNZ4UEPJ
What if I do n't have access to a computer 	I do not know what you should do if you do not have access to a computer 	A2LQ9NP944M61Z
Will I be able to use my reward points for next in stotre purchase 	I do not know if you will be able to use your reward points for your next store purchase 	A31A4YKVSOYRVS	
How can I be sure that it is the same room type 	I do not know how you can be sure that it is the same room type 	A2NI2HSU84PHJW
What are the benefits of conducting an exit interview 	I do not know the benefits of conducting an exit interview 	A1J0GU26323WVA
Do you offer scholarships for citizens of my country 	I do not know if we you offer scholarships for citizens of your country 	A3RD486RQUI2XV
What time do we have to arrive for the tour 	I do not know what time you have to arrive for the tour 	A10249252O9I20MRSOBVF
Will I need to pay tax in my state 	I do not know if you will need to pay taxes in your state	AYJGJAIY0EXW
Are any of the films inside the museum for sale 	I do not know if any of the films inside the museum are for sale 	A2K2MFQMN31DZ
How can you access your student 's account 	I do not know how I can access my student 's account 	A2RHBR7XZGUI1C
Does my signature on the Performance Appraisal Form -LRB- PAF -RRB- mean that I agree with the reviewer ratings and comments 	I do not know if your signature on the Performance Appraisal Form -LRB- PAF -RRB- means that you agree with the reviewer ratings and comments 	A3RD486RQUI2XV
Can I leave the museum and come today	I do not know if you can leave the museum and come today	A23CTGXNDDW5LC
Can I have my dog be beneficiary of my insurance policy 	I am not able to make your dog the beneficiary of your insurance policy 	AE9M4Z1NCYSDM	
Are there movie sets in the Alabama Hills that can be visited 	I do not know if the movie sets in the Alabama Hills can be visited 	A2NI2HSU84PHJW
Can you alter my subscription to include more channels 	I am not able to alter your subscription to include more channels 	A1GAARR4GOOZCO	
I received an error when I tried to check out with my credit card 	I do not know why you received an error when you tried to check out with your credit card 	ASFR82SJYMGNU
Is breakfast included 	I do not know if breakfast is included 	A1AF392CLGHH0X
Where are you located on the Strip	I am not able to tell you where I am located on the strip 	A18RMWE4BKHG6R
How do I pay with a gift card 	I do not know how you pay with a gift card 	A31A4YKVSOYRVS	
Can we get inside any of the aircraft	I do not know if you can get inside any of the aircrafts 	A3SS1F4F3JE7CU
Can you cancel my subscription for next month 	I am not able to cancel your subscription for next month 	A1J0GU26323WVA	
Do you offer repair services as well	I do not know if we offer repair service	AYJGJAIY0EXW
How are coupons and discounts handled 	I do not know how coupons and discounts are handled 	A2K9PB0U45O0MU
When is tuition due 	I do not know when tuition is due	ATQD23E8ESFSI
My passport with my visa was stolen , what should I do 	I do not know what you should do 	A2NI2HSU84PHJW
Will I lose time on my membership if I renew early 	I do not know if you will lose time on your membership if you renew early 	A1RVRBKEQL1ZPG
Can I volunteer with the Virginia Zoo 	I do not know if you can volunteer with the Virginia Zoo 	A2K9PB0U45O0MU
How is overtime determined for prior pay period corrections 	I do not know how overtime is determined for prior pay period corrections 	A2TP3K1THK6XRB
How long does it take to go through the Museum 	I do not know how long it takes to go through the Museum 	A1YUEWAWRZ590A
Can multiple qualifying items be purchased in a single tax-exempt transaction 	I do not know if multiple qualifying items can be purchased in a single tax-exempt transaction 	A2NI2HSU84PHJW
How do I obtain a copy of my prior year return using H&R Block online 	I do not know how you can obtain a copy of your prior year return using H&R Block online 	A1JBSFXMMRGSQD
What is proper museum etiquette 	I do not know what the proper museum etiquette is 	A2LQ9NP944M61Z
Are community property laws taken into account in determining earned income for purposes of the dependent care credit , the refundable portion of the child tax credit , the earned income credit , and the making work pay credit 	I do not know if community property laws are taken into account in determining earned income for purposes of the dependent care credit , the refundable portion of the child tax credit , the earned income credit , or the making work pay credit 	A2HKTM4Z8652
Can I take a month off of the subscription service 	I do not know if you can take a month off of the subscription service	A23CTGXNDDW5LC	
Are there any items that my camper does NOT need to bring 	I do not know if there are any items that your camper does not need to bring 	A14M2EERU7E8KD
Will it stain my swimsuit 	I do not know if it will stain your swimsuit 	A1JBSFXMMRGSQD
How do I add my spouse to my account 	I do not know you add your spouse to your account 	A325WS381BHOHH	
I have received an email that claims to be from an office of the Irish Naturalisation & Immigration Service or the Irish Department of Foreign Affairs . I have concerns that it may be visa scam . Is it genuine 	I do not know if that email from the office of the Irish Naturalisation & Immigration Service or the Irish Department of Foreign Affairs is genuine 	A3RO0QIXW4IX3Y
When am I due for my next phone upgrade 	I do not know when you are due for your next phone upgrade 	A1YKWG46AWMPUX	
How do we take MAX to the zoo 	I do not know how you take MAX to the zoo 	A1J0GU26323WVA
Do you charge any extra for direct deposits 	I do not know if we charge extra for direct deposits 	A2K9PB0U45O0MU
Will there be other colors available in the future 	I do not know what colors are available	A3V8B2A5O5KIVZ	
Did Santa 's Wonderland close the Drive-Through 	I do not know if it closed the drive-through 	A2NI2HSU84PHJW
What 's next for Congress.gov 	I do not know what is next for Congress.gov	APF1EAZT104LQ
Does Zoo New England donate tickets for charitable causes 	I do not know if Zoo New England donates tickets for charitable causes 	A1S8DYWNS59XWB
Is there a big different in shipping time between the USPS and UPS 	I do not know difference in shipping time between the USPS and UPS 	AJNQ2PBD07FKE
But I 'm going during the summer 	I do not know if you are going during the summer 	A9LX66EQWDRQ5
What are the phone hours 	I do not know what the phone hours are 	A13GUTDMGGZZDL
How do I know the car is in the condition stated 	I do not know how you know the car is in the condition stated 	A1JBSFXMMRGSQD
What is a publicly available , viewable , and bookable rate 	I do not know of a publicly available , viewable , and bookable rate 	A9LX66EQWDRQ5
There are people who say that visiting a country such as North Korea is wrong and that all we are doing is supporting the government - is this true 	I do not know if visiting a country such as North Korea is wrong and that all we are doing is supporting the government 	A3U0VQ420HIMQ0
I 've changed my maiden name and would like my account to reflect that 	I am not able to make your account reflect that change 	A185P3B2MC2K83
What ports did USS Constitution visit during her National Cruise from 1931 to 1934 	I do not know what ports the USS Constitution visited during her National Cruise from 1931 to 1934 	A3I9FTHSULHPYS
Can you suspend my account until I get done dealing with an identity theft issue 	I do not know if we can suspend your account until you are done dealing with the identity theft issue 	A31A4YKVSOYRVS	
Did my parcel go out yet 	I do not know if your parcel went out yet 	A9LX66EQWDRQ5	
Can I get a discount for buying in bulk with your company 	I do not know if you can get a dscount for buying in bulk 	AD9O852KPYLHY	
Do you accept personal checks at the Zoo 	I do not know if we accept personal checks at the zoo 	AFS36YMNN8A2J
What products do you sell for children 	I do not know what products we sell for children	A23CTGXNDDW5LC
Does united.com charge any booking fees or service fees to make a reservation 	I do not know if united.com charges a booking fee or service fees to make a reservation	A1CMT9MVUO52VP
How does the guest/caregiver benefit work 	I do not know how the guest/caregiver benefit works 	AZLZA0Q87TJZO
What types of classes do you offer 	I do not know the types of classes we offer 	A325WS381BHOHH
What should a provider be aware of when updating or reviewing contracts for the HIPAA Electronic Funds Transfer -LRB- EFT -RRB- transaction 	I do not know what a provider should be aware of when updating or reviewing contracts for the HIPAA Electronic Funds Transfer -LRB- EFT -RRB- transaction 	APC99TPURUHR8
How long is the review process , after the first review posting is listed 	I do not know how long the review process is 	A2NI2HSU84PHJW
What are your new services that I can take advantage of 	I do not know what our new services are that you can take advantage of 	A1JBSFXMMRGSQD
Do I need a parking permit to park free as a member	I do not know if you need a parking permit 	A3VSBRD9GN89I2
Does your company do a monthly newsletter 	I do not know if my company does a monthly newsletter	A23CTGXNDDW5LC
What expenses must be reimbursed 	I do not know what expenses must be reimbursed 	A16VTK6KZ1U69H
Where can I mail my payment 	I do not know where you can mail your payment to 	A31A4YKVSOYRVS	
Can my relatives or friends who do not live in my household be included on my membership card 	I do not know if your relatives or friends who do not live in your household can be included on your membership card 	A21EPR8KW0GWX2
Do you sell smart lights 	I do not know if we sell smart lights 	AE9M4Z1NCYSDM	
Who is our dental insurance carrier 	I do not know who is your dental insurance carrier 	A3CL6GEDFNQGQY
Where can I find information about training and museum studies 	I do not know where you can find information about training and museum studies 	A3I9FTHSULHPYS
Can I please cancel my order before it ships 	I am not able to cancel your order before it ships	A224I9B6RFJZEI	
Are wheelchairs and strollers available 	I do not know if wheelchairs and strollers are available 	A36EXF1KC09IER
Have other customers complained about the quality of this product 	I do not know if other customers have coplained about the quality of this product 	A1CQPRZUT6BW44
Is there a place to change 	I do not know if there is a place to change	ATQD23E8ESFSI
How do I know if my device is compatible with the My Verizon app 	I do not know if your device is compatible 	A2866TYG0D96LM
If an overdraft charge was caused by a fraudulent charge , can it be reversed 	I do not know if an overdraft charge caused by a fraudulent charge can be reversed 	A325WS381BHOHH	
Does the Federal Reserve own or hold gold 	I do not know if the Federal Reserve owns or holds gold 	A2K9PB0U45O0MU
Can I cover my domestic partner and his/her child or children 	I do not know if you can cover your domestic partner and his/her child or childern 	A3I9FTHSULHPYS
What is your return policy 	I do not know what the return policy is 	AD9O852KPYLHY	
Please cancel my order , if it is possible 	I am not able to cancel your order	A23CTGXNDDW5LC
What support can I get if I have a problem or any other question 	I am not able to tell you what support you can get if you have a problem or other question 	A2UBEPT605E8T2
Email the online store and we can assist you in finalising your order 	I am not able to email the online store 	A20WRVVT7WQFT7
Can the museum be observed by the organizer of a tour in advance 	I do not know if the measure can be observed in advance 	A2NI2HSU84PHJW
Is there a shop at the Museum 	I do not know if there is a shop at the Museum 	A3I9FTHSULHPYS
Can I drop my child off at the museum 	I do not know if you can drop your child off at the museum 	A3I9FTHSULHPYS
Why was I charged twice for the same item 	I do not know why you were charged twice for the same item 	A3GNQDFPZALU92	
How do I find information on the new HR Website 	I am not able to tell you how to find information on the new HR Website	A355BVFIOODRH2
What action should an employer take if an overpaid employee refuses to consent to the employer 's request to seek a refund of the overpaid FICA taxes 	I do not know which action should be taken if an overpaid employee refuses the request to seek a refund on FICA taxes that were overpaid 	APF1EAZT104LQ
What is the best way to store my Matcha 	I do not know the best way to store matcha 	A2NI2HSU84PHJW
Why is my payment being declined	I do not know why your payment was declined 	A1HQRT1UG6ERGL
I ordered my product last week , can you please tell me why I have not received it yet 	I do not know why you have not received it yet 	A1CQPRZUT6BW44
What is a passport submission appointment and why is it necessary 	I do not know what a passport submission appointment is , or why it is necessary 	A2NI2HSU84PHJW
How long is my application kept on file 	I do not know how long your application is kept on file 	A9LX66EQWDRQ5
How much up-keep is involved with keeping this product running smoothly 	I do not know how much up-keep is involved in keeping this product running smoothly 	A3U6CLX7HD0SMF	
What are the benefits of Family Membership 	I do not know what are the benefits of Family Membership 	A3SS1F4F3JE7CU
How much does the Artmobile cost 	I do not know how much the Artmobile costs 	A3G2FBKYCRD5Q8
Why do adults need to pay admission at a children 's museum 	I do not know why adults need to pay admission at a children 's museum 	A3U6CLX7HD0SMF
Are ATM 's available 	I do not know if any ATM 's are available 	A3SQIRU1XI54BR
Are all of the museum 's aircraft and exhibits featured on your website 	I do not know if all of the museum 's aircraft and exhibits are featured on our website 	A116N2LEI6O7HB
What information will be on the IDNYC card 	I do not know what information will be on the IDNYC card	A23CTGXNDDW5LC
Can I make repairs to my lease vehicle so I do n't incur wear and use charges 	I do not know if you can make repairs to your lease vehicle 	A13GUTDMGGZZDL
What data do I have access to 	I do not know what data you have access to 	A9LX66EQWDRQ5
If , due to a disability , I am unable to travel to an IDNYC enrollment center , how can I apply for my IDNYC card 	I do not know how you would apply for an IDNYC card in case of a disability 	A16NITTBMCSN0V
Can I bring alcoholic beverages to the Getty Center 	I do not know if you can bring alcoholic beverages to the Getty Center 	A1XNCA1SVTT15B
What form of payment will you accept 	I do not know what form of payment we will accept 	AE9M4Z1NCYSDM	
Do you know if you 're currently hiring 	I do not know if we are currently hiring 	AMW07CJC3OJIB
Who is the President of Pacific 	I do not know who the President of Pacific is 	APC99TPURUHR8
How long will she nurse 	I do not know how long she will nurse 	A7SXWHGK8B40R
Where are your webcams 	I do not know where our webcams are 	A13GUTDMGGZZDL
When can I start using the membership 	I do not know when you can start using the membership 	A3U0VQ420HIMQ0
How can students pay their application fee at a later date 	I do not know how students can pay their application fee at a later date	A1GNG0J27JYSUB
Why is a safe and functional courthouse important 	I do not know why a safe and functional courthouse is important 	A1AVKKVWWFUGLT
What if I have a problem with my spot or positioning 	I am not able to help you with spot or positioning problems 	A1NF93LWL8ABHH
How do I make corrections to prior time sheets 	I do not know how you make corrections to prior time sheets 	A1X3SF2W1QQBY1
Can I take photos in the museum 	I do not know if you can take photos in the museum 	A116N2LEI6O7HB
I am the PD/PI on an NIH grant , but I am not the responsible party for the clinical trial that the grant supports . If the trial is not in compliance with FDAAA or in adherence with the NIH Policy on the Dissemination of NIH-Funded Clinical Trial Information , may I register or submit results of the trial in ClinicalTrials.gov 	I do not know if you may register or submit results of the trail in ClinicalTrials.gov 	A7SXWHGK8B40R
How long before my session times out 	I do not know how long before your session times out 	A9LX66EQWDRQ5
What time is my appointment 	I do not know what time your appointment is 	A3LNWUYXJH1EUC
Is this an NFL licensed jacket	I do not know if this is an NFL licensed jacket 	A3SSJNH5SIZUPG	
What do the campers do all day 	I do not know what the campers do all day 	A3RD486RQUI2XV
Can you tell me where the product was made 	I do not know where the product was made 	AE9M4Z1NCYSDM	
How do I calculate dimensional weight 	I do not know how you calculate dimensional weight 	AJ7E01X4TAGHL
What is the difference between an add-on and a re-buy 	I do not know what is the difference between an add-on and a re-buy 	A1IMICF9ISISZN
What is your return policy 	I do not know what our return policy is 	A8F4B0854KTXO	
How does TurboTax know which questions to ask 	I do not know how Turbo Tax know which questions to ask 	A3RD486RQUI2XV
What fees are there besides the purchase price 	I do not know what fees there are besides the purchase price 	A3I9FTHSULHPYS
Will I be able to exit the venue and return during the concert or event	I do not know if you will be able to exit the venue and return during the concert or event 	A3SS1F4F3JE7CU
What if we ca n't afford to pay admission 	I do not know what you should do if you ca n't afford to pay admission 	A13GUTDMGGZZDL
I need to delay my subscription 	I am not able to delay your subscription	APF1EAZT104LQ
How can I apply for copyright permission to use material from a Museum publication 	I do not know how you can apply for copyright permission 	A3B2YRXL26RPVH
What size companies do you typical work with and is a company ever too small or too large for you to support 	I do not know what size companies we work with or if a company is too small or too large for us to support 	A2K9PB0U45O0MU
How much does TurboTax Online cost 	I do not know how much TurboTax Online costs 	AFS36YMNN8A2J
May I bring my dog 	I do not know if you may bring your dog 	AZLZA0Q87TJZO
Can my child attend Camp with a friend 	I do not know if you child can attend Camp with a friend 	APC99TPURUHR8
Can I copy and paste information into my Grants.gov application from a Microsoft Word document 	I do not know if you can copy and past information in your Grants.gov application 	A325WS381BHOHH
My order is late , please check on it 	I am not able to check on your order 	A9LX66EQWDRQ5	
What are some ' little known treasures ' on campus 	I do not know any ' little known treasures ' on campus 	A2K9PB0U45O0MU
Do you offer digital gift cards that I can email to someone 	I do not know if we offer digital gift cards that you can email to someone	A23CTGXNDDW5LC	
Wuksachi Lodge - No Elevators	I do not know if Wuksachi Lodge has no elevators 	APC99TPURUHR8
Do you offer any Zumba classes in the evenings 	I do not know if we offer any Zumba classes in the evenings 	A2EAJXBORHT44T	
when is the best time to visit this city 	I do not know when the best time to visit the city is 	A31A4YKVSOYRVS	
When may I visit and how long may I stay 	I do not know when you may visit or how long you may stay 	A2K2MFQMN31DZ
What is the University 's Employer Registered Number 	I do not know what the University 's Employer Registered Number is 	A2EJ7U3TZAKROG
Does Zoo College provide me with standard college or university credits toward my degree 	I do not know if Zoo College provides standard college or university credits toward your degree 	A2NI2HSU84PHJW
Please tell me the best way I can go about making a claim or a dispute for this product 	I am not able to tell you the best way you can go about making a claim or a dispute for this product 	A325WS381BHOHH	
What are the different plans you offer for the subscription 	I do not know all the plans that are offered with the subscription 	AEXWOFM1LGS6U
Can I place an order online and then go to a local store location to get it	I do not know if you can place an order online and then go to a local store location to get it	A23CTGXNDDW5LC
Does Mandalay Bay offer AARP , AAA or Government rates 	I do not know if Mandalay Bay offers AARP , AAA or Government rates 	A5VBIZ2KIQ1R8
Can DynamoDB be used by applications running on any operating system 	I do not know if DynamoDB can be used by applications running on any operating system 	A13GUTDMGGZZDL
What type of atmosphere does your studio have 	I do not know what type of atmosphere the studio has 	A10249252O9I20MRSOBVF
Do I have to file a FAFSA 	I do not know if you have to file a FAFSA 	A1S8DYWNS59XWB
Is the loss on the sale of my home deductible 	I do not know if the loss on the sale of your home is deductible 	A2NI2HSU84PHJW
Can we take lessons every other week instead of every week 	I do not know if you can take lessons every other week 	A2NI2HSU84PHJW
Is smoking marijuana permitted at your property 	I am not able to tell you if smoking marijuana is permitted 	A2UBEPT605E8T2
What if a collection does fall under the ZLA but might be eligible for a dispensation 	I do not know what happens if a collection falls under the ZLA but might be eligible for a dispensation 	AZLZA0Q87TJZO
Can I look up my gift card balance online 	I do not know if you can look up your gift card balance online 	A16VTK6KZ1U69H
What sorts of loyalty programs do you offer 	I am not able to explain what loyalty programs we offer 	AE9M4Z1NCYSDM	
My service was supposed to start yesterday and it 's still not working , help 	I am not able to help you with your service 	A325WS381BHOHH	
Can I arrange to have materials waiting for me when I get there 	I do not know if you can arrange to have materials wating for you 	A13GUTDMGGZZDL
Do you offer payment plans for re-activation 	I do not know if we offer payment plans for re-activation 	AMW07CJC3OJIB
I have never purchased online tickets from BAMPFA , but when I enter my email address it says I already have an account . What is going on 	I do not know what is going on	A23CTGXNDDW5LC
Are all Brooklyn Museum exhibitions appropriate for children to view 	I do not know if all Brooklyn Museum exhibitions are appropriate for children 	A2NI2HSU84PHJW
Are there safety restrictions 	I do not know if there are safety restrictions 	APC99TPURUHR8
What does my general admission ticket include 	I do not know what my general admission ticket includes 	A1JBSFXMMRGSQD
Do we have to have a formal referral to get an assessment	I do not know if you need to have a formal referral to get an assessment 	A298FAWY76NZA9
What steps can an employer take to reduce the risk of exposure of the Zika virus in the workplace 	I do not know what steps an employer can take to reduce risks 	A325WS381BHOHH
How big should my tree be 	I do not know how big your tree should be 	AF8KEA2127EAN
Can I personally deliver the donation to the museum 	I do not know if you can personally deliver the donation to the museum 	A7SXWHGK8B40R
When does the East Bay Plaza stream open 	I do not know when the East Bay Plaza stream opens 	A3I9FTHSULHPYS
What are the laws on paid and unpaid breaks 	I do not know what the laws are on paid and unpaid breaks 	AZLZA0Q87TJZO
Why ca n't I access my account 	I do not know why you ca n't access your account 	A31A4YKVSOYRVS	
What should I wear for class 	I do not know what you should wear for class 	A2HKTM4Z8652
I 've created media using the media creation tool , now what do I do 	I am not able to tell you what to do now 	A3CL6GEDFNQGQY
Has the price dropped recently 	I do not know if the price dropped recently 	A3VV5FFG6GXE1S	
Do you have an annual recital 	I do not know is there is an annual recital 	A16NITTBMCSN0V
Do school children need to be accompanied 	I do not know if school children need to be accompanied 	A13GUTDMGGZZDL
Are your animals healthy & clean 	I do not know if our animals are healthy and clean 	A2NI2HSU84PHJW
What are the ZOOfriends membership office hours 	I am not able to tell you the office hours of ZOOfriends	APF1EAZT104LQ
How much do I pay for my benefits 	I do not know how much you pay for your benefits 	A2TP3K1THK6XRB
I need to know how much in total I paid in 2016 	I do not know how much you paid in 2016 	AD9O852KPYLHY	
What is SMoCA 	I do not know what SMoCA is 	A2K9PB0U45O0MU
How often do you restock supplies 	I do not know how often we restock supplies 	AD9O852KPYLHY	
What determines my eligibility for a job 	I do not know what determines your eligibility for a job 	A2K9PB0U45O0MU
Can I take photographs in the galleries -LRB- camera , digital camera , video camera , etc. -RRB- 	I do not know if you can take photographs in the galleries 	A3UJE4WA5XADZS
I like to plan ahead . Can I purchase tickets before I get there 	I do not know if you can purchase tickets before you get there 	A5VBIZ2KIQ1R8
Are strollers allowed in the Museum 	I do not know if strollers are allowed in the museum 	A2VIKCIM9TZL22
I ordered an item but now I received an email saying the item is out of stock 	I do not know why you received an email saying the item is out of stock	AYJGJAIY0EXW
WHAT ARE THE STADIUM TOURS & MUSEUM OPENING HOURS	I do not know what the opening hours are 	A3722NOMVUK89T
When is it considered too late to cancel my request 	I do not know when it is considered too late to cancel your request 	A3U6CLX7HD0SMF	
When an employer hires a remote employee , how should the employer complete the Form I-9 	I am not able to tell you how an employer should complete the Form I-9 when they hire a remote employee 	A116N2LEI6O7HB
How do I approve a new requisition 	I do not know how you approve a new requisition 	A2HKTM4Z8652
How can an employer ensure that job applicants see its general notice of the Family and Medical Leave Act -LRB- FMLA -RRB- 	I do not know how an employer can ensure that job applicants see its general notice of the Family and Medical Leave Act -LRB- FMLA -RRB- 	A2HKTM4Z8652
Do you mind if I eat a competitors product in your store as long as I buy some of your product too so I can compare them 	I do not know if you can eat a competitor 's product in our store as long as you buy some of our product too to compare them 	A3B1H161LQLAYP	
Can I get notified when an item is back in stock 	I am not able to determine if you can be notified when an item is back in stock 	AJQGWGESKQT4Y
How do I change the taxes withheld from my UC pension 	I do not know how you can change the withholding amount from your UC pension 	A18RMWE4BKHG6R
Can I request next day shipping 	I do not know if you can request next day shipping 	A9LX66EQWDRQ5	
How do I search for current openings at Dell 	I do not know how you search for current openings at Dell 	A1IMICF9ISISZN
If there is an exhibition held at the museum , is it included in the admission 	I do not know if it is included in the admission 	A7SXWHGK8B40R
Is there a cost to join the Choice Privileges program 	I do not know if there is a cost to join the Choice Privileges program 	A1JBSFXMMRGSQD
As the owner of a business , am I required to complete Form I-9 , Employment Eligibility Verification 	I do not know if you are required to complete Form I-9 , Employment Eligibility Verification 	A2EJ7U3TZAKROG
What meals are included with the hotel rate 	I do not know what meals are included with the hotel rate 	A31A4YKVSOYRVS	
I 'd like to check for a part number 	I am not able to check for a part number	A23CTGXNDDW5LC
Can I take pictures or video inside the Uffizi Gallery 	I do not know if you can take pictures or video inside of the Uffizi Gallery 	A234VIHHUHPZG5
What are the Law Enforcement Support team 's hours of operation 	I do not know the Law Enforcement Support team 's hours of operation 	A2VFX3J4B1I22X
What should I wear for a dance class 	I do not know what you should wear for a dance class 	APC99TPURUHR8
Does Kern County offer preference to veterans 	I do not know if Kern County offers preference to veterans 	APC99TPURUHR8
When is the next generation of your phone coming out 	I do not know when the next generation of our phone is coming out 	AD9O852KPYLHY	
When will I hear from Volunteer Services about my application 	I do not know when you will hear about your application 	A13GUTDMGGZZDL
How do I report the sale of my second residence 	I do not know how you can report the sale of your second residence 	A8O98QNRG9SHV
How do I apply for TSA Pre ✓ ® 	I do not know how you apply 	A13GUTDMGGZZDL
Can I take pictures or videos in the Museum	I do not know if you can take pictures or videos in the museum	ABWW1P7GZ4C0Z
What is my order history 	I do not know what your order history is 	A31A4YKVSOYRVS	
What is included in the tour 	I do not know what is included in the tour 	A1JBSFXMMRGSQD
What 's the balance on my account	I do not know the balance on your account 	A1YKWG46AWMPUX	
Is there anything we should be aware of if visiting the museums in a large group -LRB- 10 or more people -RRB- 	I do not know if there is anything you should be aware of when visiting the museums in a large group of 10 or more people 	A1JBSFXMMRGSQD
I have a collection of artwork which I am interested in selling / donating to the museum , who do I get in touch with 	I do not know who you get in touch with if you are interested in selling/donating your collection of artwork to the museum 	A16VTK6KZ1U69H
I reserved a flight by phone , but can I pay for it online with a credit card 	I do not know if you can pay online with a credit card for you flight you reserved by phone 	A2UBEPT605E8T2
I opened the package and they were spoiled - will you send a refund or coupon 	I am not able to send a refund or coupon 	AJKA9BKC011F2
Are Your products RoHS -LRB- restriction of HAZARDOUS SUSTANCES -RRB- compliant	I am not able to tell you if our products are Restriction of Hazardous Substances compliant 	AT7ADQKXKXEWY
How often should I come in for my lessons	I do not know how often you should come in 	A13GUTDMGGZZDL
Prior to administrative penalties , what enforcement actions were available to CDPH to use against hospitals out of compliance with the law 	I do not know prior to administrative penalties what enforcement actions were available to CDPH to use against hospitals out of compliance with the law 	A3G2FBKYCRD5Q8
How do I evict a tenant 	I do not know how to evict a tenant 	ANMD34DNHLOLC
How do I reset the password if I do n't have access to the original email address 	I do not know how to reset the passwork if you do n't have access to the original email address 	A325WS381BHOHH	
When I am automatically upgraded , how do you assign my seat 	I do not know how we assign your seat when you are automatically upgraded 	AZLZA0Q87TJZO
Who do I contact regarding questions 	I do not know who you contact regarding questions	A1GNG0J27JYSUB
If a department wants a wall clock who will pay for it and what is the process of ordering on 	I do not know what the process of ordering a wall clock is or who will pay for it if a department wants one 	A2HKTM4Z8652
How much is actually being donated 	I do not know how much is actually being donated 	A3MZE4FJ658B79
What options are available to lower my interest rate 	I do not know any options to lower your interest rate 	A3LNWUYXJH1EUC
I need to make sure you have my correct mailing address 	I do not know if we have your correct mailing address	A23CTGXNDDW5LC	
What is the FOMC and when does it meet 	I do not know that the FOMC is or when it meets 	A116N2LEI6O7HB
Where are the dinosaurs 	I do not know where the dinosaurs are 	A7SXWHGK8B40R
Do you have locker rooms and showers 	I do not know if we have locker rooms or showers 	A2K9PB0U45O0MU
Where can I get a newsletter for your products 	I do not know where you can get a newsletter for our products 	A3RD486RQUI2XV
How do I schedule a training program for my department 	I do not know how you schedule a training program for your department 	A1JBSFXMMRGSQD
How can I subscribe to newer packages that are offered 	I do not know how you can subscribe to newer packages that are offered 	A3RD486RQUI2XV
Are you open every day 	I do not know if we are open every day	A3NHJPE6326P9V
How do shellfish establish themselves on the sea bottom 	I do not know how shellfish establish themselves on the sea bottom 	A3G2FBKYCRD5Q8
How is check - in or registration handled for the competition 	I do not know how check-in or registration is handled for the competition 	A10249252O9I20MRSOBVF
When will the new version be out 	I do not know when the new version will be out 	A31A4YKVSOYRVS	
Do you off this item in different colors 	I do not know if this item is offered in different colors 	A3U6CLX7HD0SMF	
What are some key aspects of an active shooter drill 	I do not know key aspects of an active shooter drill 	A1JBSFXMMRGSQD
I will still get service even if I live way up north 	I do not know if you will get service if you live way up north 	A31A4YKVSOYRVS	
Ordering articles with Blue Credits	I do not know if you can order articles with blue credits	APF1EAZT104LQ
My visa has been refused and I am waiting on a refund from the university/college . Can the INIS help 	I do not know if the INIS can help if your visa has been refused and you are waiting on a refund from the university/college 	A16VTK6KZ1U69H
Could you please check the status of my order 	I am not able to check the status of your order 	A3SSJNH5SIZUPG	
Do you have the number of the shipper 	I do not know the number of the shipper 	A325WS381BHOHH	
I need to change my address , because I moved recently 	I am not able to change your address 	A31A4YKVSOYRVS	
If I 'm classified , can I remain classified 	I do not know if if you can remain classified if you 're classified 	A3I9FTHSULHPYS
Are there yearly salary increases 	I do not know if there are yearly salary increases 	A16VTK6KZ1U69H
Why Do Cats Knead 	I do not know why cats knead 	A5VBIZ2KIQ1R8
Can I talk to someone about cancelling or suspending my service 	I am not able to get someone for you to talk to about cancelling or suspending your service 	A31A4YKVSOYRVS	
Can I transfer my assets to avoid the Estate Recovery Program 	I do not know if you can transfer your assets to avoid the Estate Recovery Program 	A1JBSFXMMRGSQD
Could I get a list of houses sold by your firm in the last year 	I am not able to get you a list of houses sold by our firm in the last year 	A3VV5FFG6GXE1S	
How do I go about sponsoring the museum and what do I receive in return	I do not know how you go about sponsoring the museum or what you receive in return 	A2K9PB0U45O0MU
Where does the museum receive its Financial Support	I do not know where the museum receives is financial support from 	A2K9PB0U45O0MU
An employee on a performance improvement PLAN -LRB- PIP -RRB- has not improved , what can I do	I do not know what you can do is an employee on a performance plan -LRB- PIP -RRB- has not improved 	ATQD23E8ESFSI
I hold a temporary long-stay visa ' with residence permit exemption ' . Am I allowed to travel in the Schengen Area 	I do not know if you are allowed to travel in the Schengen are if you hold a temporary long-stay visa ' with residence permit exemption . '	A2K9PB0U45O0MU
What Will Happen When I am Discharged 	I do not know what will happen when you are discharged 	A1JBSFXMMRGSQD
Where do I submit my student organization 	I do not know where to submit your student registration 	A20WRVVT7WQFT7
How fast is AT&T High Speed Internet 	I do not know How fast is AT&T High Speed Internet	A3NHJPE6326P9V
How can I request a seat with extra legroom 	I do not know how you can request a seat with extra legroom 	AZLZA0Q87TJZO
Please cancel my order if it has not shipped yet 	I am not able to cancel your order 	A31A4YKVSOYRVS	
Can a hospital receive both Medicare and Medicaid EHR incentive payments 	I do not know if a hospital can receive both Medicare and Medicaid EHR incentive payments 	A3RD486RQUI2XV
Are the skeletons made of real bones 	I do not know if skeletons are made of real bones 	A1IPD4WBT3A5GG
Why should I book through the partners selected by Uffizi.org 	I do not know why you should book through the partners selected by Uffizi.org 	A235UQRA8GE18X
I work in the evenings . May I leave early 	I am not able to tell you if you may leave early when you work in the evenings 	A1JBSFXMMRGSQD
How can I book a tour 	I do not know how you can book a tour 	A16VTK6KZ1U69H
How often am I charged as a subscriber	I do not know how often you are charged as a subscriber	A23CTGXNDDW5LC
How many vehicles are on display 	I do not know how many vehicles are on display 	A2HKTM4Z8652
What is the smoking policy at the Zoo 	I do not know the smoking policy at the zoo	A16184N1RO5OJV
Do members qualify for free standard shipping 	I do not know if members qualify for free standard shipping 	A3RD486RQUI2XV
Do I need to check in when visiting the museum 	I do not know if you need to check in 	A13GUTDMGGZZDL
Can my friends / family come and watch 	I do not know if your friends or family can come and watch 	A13GUTDMGGZZDL
How many membership cards will I receive 	I do not know how many membership cards you will receive 	A116N2LEI6O7HB
Do training courses need to by certified by the Right to Know Advisory Committee 	I do not know if training courses need to be certified by the Right to Know Advisory Committee 	A1J0GU26323WVA
What is the latest date I can pay my bill and avoid a late fee 	I do not know the latest date you can pay your bill to avoid a late fee 	A260AFDCSXBQOH
Are there any restaurants close to the Museum 	I do not know if there are any restaurants close to the Museum 	A116N2LEI6O7HB
On what date are you offering the new model for sale to the public 	I am not able to tell you what date we are offering the new model for sale to the public 	AE9M4Z1NCYSDM	
Once I 've passed my road test , how do I get my license 	I do not know what you should do to get your license 	A13GUTDMGGZZDL
How do I arrange for a group visit or tour of the AD&A Museum 	I do not know how to arrange for a group visit or tour of the AD&A Museum 	A2K9PB0U45O0MU
Duration of a visit	I do not know the duration of a visit 	APC99TPURUHR8
What is Multi-factor authentication 	I do not know what Multi-factor authentication is 	A2K9PB0U45O0MU
How does Bucket Filling fit in with other character development programs 	I do not know how Bucket Filling fits in with other character development programs 	A1JBSFXMMRGSQD
What 's the name of your supplier 	I am not able to tell you the name of our supplier	AYJGJAIY0EXW
What additional features do i get for upgrading my plan 	I do not know what additional features you get for upgrading your plan 	A3GNQDFPZALU92	
Do you have proof of insurance and wildlife permits 	I do not know if we have proof of insurance and wildlife permits 	A3RD486RQUI2XV
Do I need to get any vaccinations before going to England 	I do not know if you need to get any vaccinations before going to England 	A7SXWHGK8B40R
What about renewal of my specialty plates 	I do not know about renewal of your specialty plates 	A2K2MFQMN31DZ
Do you offer a tracking number with standard shipping 	I do not know if we offer a tracking number with standard shipping 	A9LX66EQWDRQ5	
Is the museum 's permanent art collection searchable online 	I do not know if the museum 's permanent art collection is searchable online 	A3B2YRXL26RPVH
Is the helium dangerous if the kids inhale it from the balloons 	I do not know if the helium is dangerous if the kids inhale it from the balloons 	A325WS381BHOHH	
Is there a bulk price if I buy a certain amount 	I do not know if there is a bulk price if you buy a certain amount 	A3RD486RQUI2XV
Prior to free membership , I had a Curators ' Circle - Director 's Circle - Benefactor 's Circle - Patron 's Circle membership . How will I be recognized now that all memberships are free 	I do not know how you will be recognized now that all memberships are free 	A1X3SF2W1QQBY1
If I buy a Guided Tour for the Vatican Museums , is it possible to see the Vatican Gardens with the same ticket 	I do not know if it is possible to see the Vatican Gardens with the same ticket 	A2NI2HSU84PHJW
Where is the front entrance located	I do not know wher ethe front entrance is located 	A2LQ9NP944M61Z
Did Neil Armstrong still live in Wapakoneta 	I do not know if Neil Armstrong still lives in Wapakoneta 	A36EXF1KC09IER
Where do Dau Students Perform	I do not know where DAU students perform 	A2HKTM4Z8652
What if I am not able to pay my bill 	I do not know what if your not able to pay your bill 	A3SS1F4F3JE7CU
How do you get to the Museum 	I do not know how you get to the Museum 	A298FAWY76NZA9
Can we bring a dog to Zoo Parc Safari 	I do not know if you can bring a dog to Zoo Parc Safari 	A9LX66EQWDRQ5
Do I qualify for savings 	I do not know if you qualify for savings 	A325WS381BHOHH
If our organization has less than 50 employees , can we still purchase People-Trak HR Software 	I do not know if you can purchase People-Trak HR Software if your organization is less than 50 employees 	A2LQ9NP944M61Z
What is the tsunami warning system 	I do not know what the tsunami warning system is 	A116N2LEI6O7HB
What about other special restrictions 	I am not able to tell you about the other restrictions 	A3RD486RQUI2XV
Were only women accused of practicing witchcraft 	I do not know if only women were accused of practicing witchcraft 	A7SXWHGK8B40R
Must an employer with a self-insured health plan obtain a health plan identifier -LRB- HPID -RRB- 	I do not know if an employer with a self-insured health plan must obtain a health plan identifier -LRB- HPID -RRB- 	A1J0GU26323WVA
Can I produce hard copies of my material 	I do not know how to produce hard copies of your material 	A2VIKCIM9TZL22
I ca n't understand you very well , can we switch to french 	I am not able to switch to French 	A8F4B0854KTXO	
My child is beginning classes in the middle of a semester . Do you prorate tuition 	I do not know if we prorate tuition 	A2NI2HSU84PHJW
My creditcard is not accepted , what can I do 	I do not know what you can do if your credit card is not accepted 	A2VIN0EE9BGPSH
Can you help me track my order 	I am not able to help you track your order 	AE9M4Z1NCYSDM	
Can I change the quantity of items in my order after the purchase goes through	I am not able to change the quantity of your order 	AJNQ2PBD07FKE
What hours is your store open 	I am not able to tell you the hours our store is open 	A3RD486RQUI2XV
Am I required to attend orientation to sign up for benefits 	I do not know if you required to attend 	AOPI4DCPSO8H4
I am interested in two different history programs . Are you able to blend them into one program for my students 	I do not know if we are able to blend two history programs into one program for your students 	A1X3SF2W1QQBY1
When will I receive my first statement 	I do not know when you will receive your first statement	A23CTGXNDDW5LC	
Can I renew my warranty 	I am not able to renew your warranty 	AE9M4Z1NCYSDM	
How can I recycle used consumables 	I do not know how you can recycle used consumables 	A13GUTDMGGZZDL
Can I bring gifts and decorations 	I do not know if you can bring gifts and decorations 	A2N9AKAOR17XB3
What are the requirements for applying for a residence card , or for the issue of an address card 	I do not know what the requirements are for applying for a residence card , or for the issue of an address card 	A7SXWHGK8B40R
How can I obtain an itemized bill 	I do not know how you obtain an itemized bill 	A2NI2HSU84PHJW
What is your smoking policy 	I do not know what the smoking policy is 	A2NI2HSU84PHJW
My payment keeps being declined 	I do not know why your payment keeps being declined 	A1JBSFXMMRGSQD
Can you share details of the new studies that support the consensus that BPA is safe for humans 	I am not able to share details of the new studies that support the consensus that BPA is safe for humans 	A8O98QNRG9SHV
Why has n't my order shipped out yet 	I do not know why your order has not been shipped yet	APF1EAZT104LQ
Someone hacked into my Netflix account . Is there some way to trace this person 	I am not able to trace the person who hacked into your Netflix account 	A31A4YKVSOYRVS	
Am I able to use the gift card online 	I do not know if you are able to use the gift card online 	AE9M4Z1NCYSDM	
Can you verify that my order will arrive by the end of this week 	I am not able to verify that your order will get there by the end of this week 	A31A4YKVSOYRVS	
How much for express shipping	I do not know how much express shipping is 	A3GNQDFPZALU92	
Will I be the only adult 	I do not know if you will be the only adult 	AT7ADQKXKXEWY
How far in advance can I reserve my backcountry spots 	I do not know how far in advance you can reserve your backcountry spots 	A1JBSFXMMRGSQD
What kind of services do you offer after the sale 	I do not know what kind of services we offer after the sale 	A3GNQDFPZALU92	
I 'm coming with a group , can I reserve a picnic pavilion 	I do not know if you can reserve a picnic pavilion	A23CTGXNDDW5LC
What products are popular in my area 	I do not know what products are popular in your area	A23CTGXNDDW5LC
Can I add my company logo and customize Kin 	I do not know how you can add your company logo and customize Kin 	A3CL6GEDFNQGQY
What is your most popular add on item that people buy 	I do not know what the most popular add on item is that people buy 	AE9M4Z1NCYSDM	
What qualifications stand me in good stead for finding a job in Germany 	I do not know what qualifications stand you in good stead for finding a job in Germany 	A16VTK6KZ1U69H
How much does it cost to rent a space at Sheldon 	I do not know How much it cost to rent a space at Sheldon	ATQD23E8ESFSI
Do all those texts cost money 	I do not know if all those texts cost money 	A9LX66EQWDRQ5
How can I reserve a baby cot 	I do not know how you would reserve a baby cot 	A3RO0QIXW4IX3Y
Are pets welcome in the zoo 	I do not know if pets are welcome in the zoo 	A2UBEPT605E8T2
How long will it take for a maid to arrive 	I do not know how long it will take for a maid to arrive 	A31A4YKVSOYRVS	
How long is a visit to the Uffizi 	I do not know how long a visit to Uffizi takes 	A2D0IIX70FDQIW
What do I do if my package was stolen 	I do not know what you would do if your package was stolen 	A31A4YKVSOYRVS	
What can I bring to a Pavilion Concert	I am not able to help you with what you can bring to a pavilion concert 	A1BWNS27NA1JAP
Do you think I should buy insurance for my order 	I do not know if you should buy insurance for your order 	A9LX66EQWDRQ5	
What are some different ways I can use this product 	I do not know some different ways you can use this product	A23CTGXNDDW5LC
Will that cover guests 	I do not know if that will cover guests 	A8F4B0854KTXO	
Can you help if I 've lost my card and need help reordering 	I am not able to help if you 've lost your card and need help reordering	A23CTGXNDDW5LC
Do you allow visitors to take photos -LRB- including digital cameras -RRB- or copy the works 	I do not know if you can take photos or copy the works with any camera 	A3NZLRU95OULXB
Do you have an observation window 	I do not know if we have an observation window 	A3U0VQ420HIMQ0
Where can I find online coupons	I do not know where you can find online coupons 	A3RD486RQUI2XV
Do I value IT system reliability , efficiency and productivity , or are these things my business can do without 	I do not know if your business can do without IT system reliability , efficiency and productivity 	A3RD486RQUI2XV
What is DanceSport 	I do not know what DanceSport is 	AZLZA0Q87TJZO
Where can I find healthy recipes for different ethnicities 	I do not know where you can find healthy recipes for different ethnicities 	A2HKTM4Z8652
I think I was charged incorrectly for an item . What should I do 	I do not know what you should do if you were incorrectly charged for an item 	A31A4YKVSOYRVS	
Can I give a polygraph -LRB- lie detector -RRB- test to a prospective employee for a pharmaceutical position 	I do not know if you can give a polygraph test to a prospective employee for a pharmeceutical position 	A2115OWJ0CKOB3
Am I required to provide my employees benefits 	I do not know if you are required to provide your employees benefits 	A3E3J27LF4OX9M
Can you help me set up my voice mailbox 	I am not able to help you set up your voice mailbox 	A3GNQDFPZALU92	
I bought a new car and need to add it to my policy 	I am not able to add the new car you bought to your policy 	A31A4YKVSOYRVS	
Where are facilities available for diaper changing 	I do not know where the facilities are for diaper changing 	A7SXWHGK8B40R
Where are the dance studios and dance faculty offices 	I do not know where the dance studios and dance faculty offices are 	A2HKTM4Z8652
Where can I find information about air bags/supplemental inflatable restraints on Chevrolet vehicles 	I do not know where you can find information about air bags/supplemental inflatable restraints on Chevrolet vehicles 	A7SXWHGK8B40R
I lost something in the museum ! Who do I contact 	I do not know who you contact if you lost something in the museum 	A3U0VQ420HIMQ0
How much do the dance uniforms cost 	I do not know the cost of dance uniforms 	A2VIKCIM9TZL22
What if I do n't see my favorite non-profit on the list 	I do not know how you would be able to see your favorite non-profit on the list 	A2VIKCIM9TZL22
I 'm having trouble verifying my account , I never got an email	I am not able to help you verify your account 	A31A4YKVSOYRVS	
I lost a personal item in my room or at the Resort . How can I submit a claim 	I do not know how you could submit a claim for a lost personal item 	A2VIKCIM9TZL22
Are there any restrictions on the number of claims that I can submit 	I do not know if there are any restrictions on the number of claims you can submit 	A16NITTBMCSN0V
Do I only pay the registration fee once 	I do not know if you only pay the registration fee once	A23CTGXNDDW5LC
Is this item always in stock 	I do not know if this item is always in stock 	A3GNQDFPZALU92	
Do I need to speak Japanese 	I do not know if you need to speak Japanese 	AT7ADQKXKXEWY
What are ' Mambo Shines ' -LRB- a/k/a ' Fancy Footwork ' -RRB- 	I do not know what ' Mambo Shines ' -LRB- a/k/a ' Fancy Footwork ' -RRB- are 	AJ7E01X4TAGHL
Are there more modern or ballet courses 	I do not know if there are more modern or ballet courses 	A2K9PB0U45O0MU
What kind of shoes should I wear for my lesson	I do not know what kind of shoes you should wear 	A2NI2HSU84PHJW
how long is the average project assignment 	I do not know how long the average project assignment is	A23CTGXNDDW5LC
How old do I have to be to take class 	I do not know how old you have to be to take class 	A20WRVVT7WQFT7
How do I contact you 	I do not know how you can contact me 	A13GUTDMGGZZDL
Is your milk made with hormones 	I do not know if our milk is made with hormones 	A3VV5FFG6GXE1S	
Can I email statements from DanceStudio-Pro 	I do not know if you can email statements from DanceStudio-Pro 	AZLZA0Q87TJZO
What should I do to get a Certificate of Eligibility 	I do not know What you should do to get a Certificate of Eligibility 	A3RD486RQUI2XV
What are the key components of a retaliation policy 	I do not know the key components of a retaliation policy 	A2NI2HSU84PHJW
Does this shirt come in children 's sizes 	I do not know if this shirt comes in children 's sizes 	A31A4YKVSOYRVS	
What will I experience at World of Coca‑Cola 	I do not know what you will experience at World of Coca-Cola 	AFS36YMNN8A2J
How much is the delivery charge 	I do not know how much the delivery charge is 	A3RD486RQUI2XV
How Can I Avoid the Crowds at Old Faithful 	I do not know how you can avoid crowds at Old Faithful 	A1JBSFXMMRGSQD
Would you be able to help me set a later shipping date for my item 	I am not able to help you set a later shipping date for your item 	A9LX66EQWDRQ5	
I have n't seen any confirmation emails . Why I am not receiving emails 	I do not know why you have not received your confirmation emails 	A1HLG5NN2I16GN
I 'm a Louisville Zoo member . Do I pay a parking fee 	I do not know if you pay a parking fee	A23CTGXNDDW5LC
Can I get a fun image printed on my credit card 	I do not know if you can get a fun image printed on your credit card 	A3RD486RQUI2XV
Does the delivery driver offer change 	I do not know if the delivery driver offers change 	A2EAJXBORHT44T	
why does it say my discount code expired	I do not know why it says your discount code expired 	AJNQ2PBD07FKE
What steps should federal contractors take to ensure compliance with the OFCCP 's Final Rule regarding Section 503 of the Rehabilitation Act of 1973 	I do not know the steps federal contractors take to ensure compliance with the OFCCP 's Final Rule regarding Section 503 of the Rehabilitation Act of 1973 	A2K9PB0U45O0MU
Why are there two entries , non-series title and series title , for many headings listed in the search results of a Title Authority Heading search 	I do not know why there are two entries for some headings listed in the search results 	A3U6CLX7HD0SMF
Who is my contact	I do not know who your contact is 	A1X3SF2W1QQBY1
Do you offer shipping to Jamaica 	I do not know if we offer shipping to Jamaica 	A9LX66EQWDRQ5	
Who will be responsible for the kids during the party 	I do not know who will be responsible for the kids during the party 	A2D0IIX70FDQIW
What items are not eligible for Shipped by Newegg 	I do not know which items 	A1DWQO9X2ZQ35G
May an employer create a ' black list ' of individuals that it will refuse to hire 	I am not able to tell you if an employer may create a ' black list ' of individuals that they will refuse to hire 	A116N2LEI6O7HB
How much dance training should a prospective student have prior to attending Point Park 	I do not know how much dance training a prospective student should have prior to attending Point Park 	A116N2LEI6O7HB
Can you tell me what payment method I have on file 	I am not able to tell you what payment method you have on file 	A31A4YKVSOYRVS	
What 's the best app for menus	I do not know what is the best app for menus 	A3GNQDFPZALU92	
I 'm a Staff Member ; When Should I Call a Chaplain 	I do not know when you should call a chaplain 	A3G2FBKYCRD5Q8
I 'm Having Trouble With My Password - Can You Help 	I do not know if we can help 	A2NI2HSU84PHJW
Am I allowed to bring my stroller or carrier into the theater 	I do not know if you can bring a stroller or carrier in the theater 	A2223XYV804AY7
I need to speak to whoever is in charge 	I am not able to have you speak to whoever is in charge 	ASFR82SJYMGNU
Please check if my order is in yet 	I am not able to check if your order is in yet 	A325WS381BHOHH	
If you are n't using the spiral method of learning , what do you use 	I do not know what you use if you are n't using the spiral method of learniing 	AZLZA0Q87TJZO
How can I earn more rewards points 	I do not know how you can earn more rewards points 	AI4AO0O0WIJF7
How are bills identified 	I do not know how bills are identified 	A1XNCA1SVTT15B
Do you have kennel facilities for dogs 	I do not know if we have kennel facilities for dogs 	A2K2MFQMN31DZ
Do you have extra problems available if a student additional practice 	I do not know if extra problems are available for additional practice 	A1HLG5NN2I16GN
Can you please check if the item ingredients are the same as the previous version 	I am not able to check if the item ingredients are the same as the previous version 	A9LX66EQWDRQ5	
What 's the exchange rate for trading in books at the used-book counter 	I do not know the exchange rate for trading in books at the used-book counter 	A1GAARR4GOOZCO	
Does my boarding pass indicate that I can use the TSA Pre ✓ ® lane 	I am not able to tell if your boarding pass indicates that you can use the TSA Pre ✓ ® lane 	A2115OWJ0CKOB3
What flavors do you offer of this item 	I do not know what flavors we offer for this item 	A31A4YKVSOYRVS	
What payment structure did Oregon choose for eligible hospitals 	I do not know the payment structure Oregon chose for eligible hospitals 	A2K9PB0U45O0MU
Can I study abroad 	I do not know if you can study abroad 	A2HKTM4Z8652
I love to take photos with animals . Do you have a schedule for this activity 	I do not know if we have a schedule for taking photos with animals 	A2HKTM4Z8652
What types of visas are available for people to come to the United States 	I do not know what types of visas are available for people to come to the United States 	AISE949ZZN8HA
What should my application consist of 	I do not know what the application should consist of 	A2NI2HSU84PHJW
How can we change our company details 	I do not know how you can change your company details 	A2NI2HSU84PHJW
Can we get a refund if the weather is bad 	I do not know if you can receive a refund 	A1DWQO9X2ZQ35G
Do you have picnic areas available 	I do not know if we have any available picnic areas 	APC99TPURUHR8
Who was involved in this decision 	I do not know who is involved in this decision 	A3NZLRU95OULXB
How often can I be summoned for jury service 	I do not know how often you can be summoned for jury service 	A8O98QNRG9SHV
How can I verify that my payment went through	I do not know how to verify that your payment went through 	AJKA9BKC011F2
Can I put my membership on hold , and what 's the fee for that 	I am not able to put your membership on hold 	AD9O852KPYLHY	
Do you have a fan page 	I do not know if we have a fan page	AYJGJAIY0EXW
What exactly does it mean to have my federal student loans discharged 	I do not know what it means to have your federal student loans discharged 	A1BYVSM1G333O4
Is it possible to report for jury service but not sit on a jury 	I do not know if it is possible to report for jury service but not sit on a jury	A3R71HP45TBQ7O
Does hospice provide any help the family after the patient dies 	I do not know if the hospice provides any help for the family after the patient dies 	A7SXWHGK8B40R
Do you have any mezzanine seats still available for the play 	I do not know if any mezzanine seats are still available for the play 	A3VV5FFG6GXE1S	
Can you send me a return label 	I am not able to send you a return label 	AE9M4Z1NCYSDM	
Who provided input during the creation of the DivX DRM system 	I do not know who provided input during the creation of the DivX DRM system 	APC99TPURUHR8
I have luggage and/or a bag with me . Is there somewhere I can stow it 	I do not know where you can stow luggage and/or a bag 	A8O98QNRG9SHV
What are the names of your teachers 	I do not know what the names of my teachers are 	A2HKTM4Z8652
What is Minecraft : Education Edition 	I do not know what Minecraft : Education Edition is 	A7SXWHGK8B40R
What 's the maximum wait time I should allow for my order 	I do not know what the maximum wait time is that you should allow for your order 	A19F9CLZ0XWBYR	
when on a project assignment , who is my employer 	I do not know who your employer is when on a project assignment 	AHJYLSDFBLEWM
Where is World of Coca‑Cola located 	I am not able to search for specific answers about locations 	A1YCGICA8XCNBH
How long will the carnival be in town 	I do not know how long the carnival will be in town 	AD9O852KPYLHY	
What does it cost to visit the museum 	I do not know what it costs to visit the museum 	A2HKTM4Z8652
Can I get maps and books on Denali before I get there 	I do not know if you can get maps and books on Denali before you get there 	A9LX66EQWDRQ5
what are the customs fees for shipping this plant 	I do not know the customs fees for shipping this plant 	AE9M4Z1NCYSDM	
Are memberships tax deductible 	I do not know if memberships are tax deductible 	A1J0GU26323WVA
Can I get a free copy of Intel ® Media Server Studio 	I do not know if you can get a free copy of Intel ® Media Server Studio	ARKAJ6PL85CME
Does the Zoo have wheelchairs available for rental 	I do not know if the Zoo has wheelchairs available for rent 	A2VIKCIM9TZL22
What is in the Museums permanent collection 	I do not know what is in the museums permanent collection 	A3RD486RQUI2XV
Can I make a payment 	I do not know if you can make a payment 	A3GNQDFPZALU92	
I ca n't see certain movies and TV shows that should be in my Library . Where are they 	I do not know where the movies and TV shows are 	A1XNCA1SVTT15B
How long is the audition class 	I do not know how long the audition class is 	A30YFEIPGXNWJL
What should my dancer wear to class 	I do not know what your dancer should wear to class 	A116N2LEI6O7HB
Are there age restrictions 	I do not know if there are age restrictions 	A13GUTDMGGZZDL
What are your class sizes 	I do not know our class sizes 	A3RD486RQUI2XV
Could I change the delivery package for my service to overnight delivery 	I am not able to change the delivery package for your service to overnight delivery 	A9LX66EQWDRQ5	
What if I want a second opinion 	I do not know what happens if you want a second opinion 	A1J0GU26323WVA
Is there any way that my package would arrive by Friday 	I do not know any ways that your package can arrive by Friday 	A185P3B2MC2K83
One of my team has announced she is pregnant , what do I need to do 	I do not know what you need to do 	A2NI2HSU84PHJW
I have a non-Windows device -LRB- like an Apple -RRB- and I want to run Windows on it . Where do I get the media 	I do not know where you get the media 	A280TORYM293P6
How can I donate an object to the Museum 	I do not know how you can donate to a museaum	APF1EAZT104LQ
Can I exchange a ticket/return it for a refund 	I am not able to exchange a ticket/return for a refund 	A1J0GU26323WVA
What about aspirin and other water additives 	I do not know about aspirin and other water addititives	A1CMT9MVUO52VP
What should be kept in an Employee File and who should have access to it 	I do not know what should be kept in an Employee File and who should have access to it 	A3722NOMVUK89T
Do you guys do gift wrapping 	I do not know if we do gift wrapping 	A31A4YKVSOYRVS	
Is there still time for current DACA recipients to file a request to renew their DACA 	I do not know if there is still time for current DACA recipients to file a request to renew their DACA 	A3CL6GEDFNQGQY
Does the museum offer Coat Check Service	I do not know if the museum offers coat check service 	A1BWNS27NA1JAP
Why does Llewelyn pick up his spent rifle cartridge 	I do not know why Llewlyn picks up his spent rifle cartridge 	A13GUTDMGGZZDL
Is the USDA Database for the Added Sugars Content of Selected Foods still available 	I do not know if the USDA Database for the Added Sugars Content of Selected Foods is still available 	A2HKTM4Z8652
Am I allowed to bring food into the zoo	I do not know if you are allowed to bring food into the zoo 	A325WS381BHOHH
What does it mean if a country has an embargo or trade sanction placed on it 	I do not know what it means if a country has an embargo or trade sanction placed on it ,	ABWW1P7GZ4C0Z
Can you guarantee delivery by Christmas 	I am not able to guarantee delivery by Christmas 	AJQGWGESKQT4Y
Is it possible to ask for another card for my partner 	I do not know if you can ask for another card for your partner 	A1J0GU26323WVA	
Is food available at the museum 	I do not know if food is available at the museum 	A1YB6WRWEXG1OC
How do I print a summary of my benefit elections 	I do not know how you print a summary of your benefit elections 	A3B2YRXL26RPVH
My monthly supply has ran out before I recieved my new supply 	I am not able to send your new supply 	A185P3B2MC2K83
Can I apply my recent admission toward the purchase of a membership	I do not know if you can apply your recent admission toward the purchase of a membership 	A2TP3K1THK6XRB
Is there any way to personalize the fruit that comes with my order 	I do not know if there is any way to personalize the fruit that comes with your order 	A2EAJXBORHT44T	
Where should I go when I arrive 	I do not know where you should go upon arrival 	A2VIKCIM9TZL22
How can I prepare for the test 	I do not know how you can prepare for the test 	A3SS1F4F3JE7CU
What 's The Verizon Plan , and can I still sign up for it 	I do not know what the Verizon plan is or if you can still sign up for it 	A3RD486RQUI2XV
Where can I find my XFINITY username and password 	I do not know where you can find your XFINITY username and password 	A3CL6GEDFNQGQY
A follow up to Question 6 , but instead of sending the mailing out to all my customers , I want to send it out only to those customers for whom I arranged financing . Do I need to give an opt-out notice before I give the outside marketing company my customer list 	I do not know if you need to give an opt-out notice before you give the outside marketing company your customer list 	A2K9PB0U45O0MU
Do you sell rock hammers , tumblers or other rock hounding equipment 	I am not able to sell rock hammers , tumblers , or other rock hounding equipment 	A11TABPKSVOOFT
Is there a physical catalog that can be mailed to me 	I do not know if there is a physical catalog that can be mailed to you	A23CTGXNDDW5LC
If we book a Vatican tour rather than just entrance tickets , will we avoid any lines , such as getting in the Sistine Chapel 	I do not know if you will avoid any lines 	A1XNCA1SVTT15B
Could you please update my credit card information 	I am not able to update your credit card information 	A185P3B2MC2K83
Do we have a space to keep coats and bags during our visit 	I do not know if you will have space to keep coats and bags during your visit 	A2EJ7U3TZAKROG
What 's the deal with the insane shipping costs 	I do not know what the deal is with the insane shipping costs	AYJGJAIY0EXW
Is the use of virtual credit cards for health care claim payments covered by HIPAA transactions requirements 	I do not know if the use of virtual credit cards for health care claim payments are covered by HIPAA transactions requirements 	A2I4VNAS21FXCE
How should we dress for class 	I do not know how you should dress for class 	A2ZBJWQ9ZZHYYI
Do n't I have to be paid for on-call time 	I do not know if you have to be paid for on-call time 	A2UBEPT605E8T2
Do you offer any bundle packages 	I do not know if we offer any bundle packages 	A9LX66EQWDRQ5	
Can I add a product to my order 	I am not able to add a product to your order 	A185P3B2MC2K83
Will I need to provide my own computer/laptop if I choose to telecommute 	I do not know if you will need to provide your own computer/laptop if you choose to telecommute 	A2K9PB0U45O0MU
How are 401 -LRB- k -RRB- plan distributions and hardship withdrawals taxed 	I do not know how 401 -LRB- k -RRB- plan distributions and hardship withdrawals are taxes	A1JQZLDXTQ99VL
Do you validate parking 	I do not know if we validate parking 	A2K9PB0U45O0MU
Is there cell phone service at the Getty Center 	I do not know if there is cell phone service at the Getty Center 	A2D0IIX70FDQIW
Where do I find out how many hours of Public or Community Service I have left 	I do not know where you find out how many hours of service you have left 	A298FAWY76NZA9
Can I pay over the phone 	I do not know if you can pay over the phone 	AD9O852KPYLHY	
What TV packages are available 	I do not know what TV packages are available 	A3I9FTHSULHPYS
Why should I pay for return shipping 	I do not know why you should pay for shipping 	A2IXBTOWQRCLPZ	
Bookmark Print Email to Colleague May an employer require its employees to work overtime 	I do not know an employer requires its employees to work overtime	A16184N1RO5OJV
Which machine learning algorithms can be considered as among the best 	I do not know which machine learning algorithims can be considered as among the best 	A2K2MFQMN31DZ
What types of photography or videography are allowed in the Museum 	I do not know what types of photography or videography that are allowed in the Museum 	A1R1J3GL0YP7DJ
What forms of payment are accepted	I do not know what forms of payment are accepted 	A3RD486RQUI2XV
What happens if an employer and union reach a deadlock in negotiations and can not agree on all the terms of the collective bargaining agreement 	I do not know what happens if an employer and union reach a deadlock in negotiations and can not agree on all the terms of the collective bargaining agreement 	A3I9FTHSULHPYS
What subscription options are available 	I do not know what subscription options are available 	A185P3B2MC2K83
Does the museum offer discounted membership rates for students or seniors 	I do not know if the museum offers discounted membership rates for students or seniors 	ARKAJ6PL85CME
How much does it cost to join 	I do not know how much it costs to join 	A2NI2HSU84PHJW
Do I need to audition for classes 	I do not know if you need to audition for classes 	A2HKTM4Z8652
Are Kia vehicles sold nationwide 	I do not know if Kia vehicles are sold nationwide 	AQ9Y6WD8O72ZC
I would like to withdraw cash from my account 	I am not able to help you withdraw cash from your account 	A1YKWG46AWMPUX	
I would like to know the status on my application that I have submitted 2 days ago	I am not able to tell you the status on the application that you have submitted 2 days ago	AYJGJAIY0EXW
Do you sell matcha in tea bags 	I do not know if we sell matcha in tea bags 	A3SS1F4F3JE7CU
Are there vending/dining facilities on-site 	I do not know if there are vending machines located at those facilities 	A9A2IX3OBORBE
What are the different fields of study in data mining 	I do not know the different fields of study in data mining 	A2K9PB0U45O0MU
When will I get my package delivered from you 	I do not know when you package from us will be delivered 	AE9M4Z1NCYSDM	
You sent me the wrong item	I am not able to assist you with a wrong item sent 	AXY0D2AMLKE2A
Why would the laws of Maryland apply to disputes with this program 	I do not know why they would apply 	A1DWQO9X2ZQ35G
Do these soak up water well	I do not know if these soak up water well 	A31A4YKVSOYRVS	
Do you know when this item typically ships 	I do not know when this item typically ships 	A8F4B0854KTXO	
Is there a chance I can pay once for a yearly subscription instead of monthly 	I do not know if you can pay once for a yearly subscription instead of monthly 	A3RD486RQUI2XV
After I have applied online , how can I contact a hiring manager or a recruiter 	I do not know how you can contact a hiring manager or a recruiter 	A3G2FBKYCRD5Q8
What would be the easiest way to split my balance between two accounts 	I do not know the easiest way to split your balance between two accounts 	A3VV5FFG6GXE1S	
What constitutes a ' public ' screening 	I do not know what constitutes a public screening 	A13GUTDMGGZZDL
When do I need to provide my financial statement 	I do not know when you need to provide your financial statement 	A16VTK6KZ1U69H
How old is the Virginia Zoo 	I do not know how old the Virginia Zoo is 	A3RD486RQUI2XV
How can I subscribe to Kia 's Open Road Magazine 	I do not know how you can subscribe to Kia 's Open Road Magazine 	A3NZLRU95OULXB
What kinds of legal processes are there that would request customer information from CenturyLink 	I am not able to tell you the kinds of legal processes that would request customer information from CenturyLink 	AT7ADQKXKXEWY
I do n't have a credit card , can I still buy tickets online 	I do not know if you can still buy tickets online without a credit card 	A2LQ9NP944M61Z
Where can I get a scholarship application form 	I do not know where you can get a scholarship application form 	A9LX66EQWDRQ5
Where can I find the store nearest to me	I do not know where the store nearest you is 	AJ7MWBQFNH3E4
Could someone who is n't good with technology figure out how to use this product 	I do not know if someone who is n't good with technology could figure out how to use this product 	A31A4YKVSOYRVS	
How should I dress for my audition 	I do not know how you should dress for your audition 	APC99TPURUHR8
Will I be able to receive calls and text messages while browsing the Web with att.net 	I do not know if you 'll be able to receive calls and text messages 	A13GUTDMGGZZDL
Can I defer a position once offered and accepted 	I do not know if you can defer a position once offered and accepted 	A3G2FBKYCRD5Q8
Can I recline my seat 	I do not know if you can recline your seat 	A7SXWHGK8B40R
Does Beiersdorf also produce goods for other retail brands 	I do not know if Beiersdorf also produces goods for other retail brands 	A9LX66EQWDRQ5
Where can I find class prices 	I do not know where you can find class prices 	A1X3SF2W1QQBY1
Is there a charge to see the DAR Museum 	I do not know if there is a charge to see the DAR Museum 	A9LX66EQWDRQ5
I placed an order yesterday , and wanted to know if I could change to expedited shipping 	I do not know if you can change it to expedited shipping 	AD9O852KPYLHY	
What if it rains during my visit 	I do not know what happens if it rains during your visit 	A2NI2HSU84PHJW
Is this your newest product 	I do not know if this is our newest product 	A3G2FBKYCRD5Q8	
Is the activity cancelled if it rains	I do not know if the activity is cancelled if it rains 	A1JBSFXMMRGSQD
How do I sign up for multi-factor authentication 	I do not know how you sign up 	A13GUTDMGGZZDL
What should I do if I forget my account Password	I do not know what can be done if you have forgot your account password 	A234VIHHUHPZG5
If I 'm late with my check is there a fee 	I do not know if there is a late fee 	AJKA9BKC011F2
What documents do I need to visit Guatemala	I do not know what documents you need to visit Guatemala 	A3G2FBKYCRD5Q8
Can I make a reservation using your mobile app 	I do not know if you can make a reservation using our mobile app 	A2IXBTOWQRCLPZ	
Can I visit England on a budget 	I am not able to tell you if you can visit England on a budget	APF1EAZT104LQ
What makes it a right whale 	I do not know why the animal is called a right whale 	A16NITTBMCSN0V
Should an employer monitor or restrict the use of Google Glass in the workplace 	I do not know if an employer should monitor or restrict the use of Google Glass in the workplace 	A7SXWHGK8B40R
Can my bill due date be extended by two weeks 	I do not know if your bill due date can be extended by two weeks	AYJGJAIY0EXW
Can I bring food and beverages to the Zoo 	I do not know if you can bring food and beverages to the Zoo 	A3I9FTHSULHPYS
When someone agrees to finance the purchase of a car with my dealership , they sign a retail installment contract . I immediately assign the contract to a third party lender . Do I have to give a privacy notice to the purchaser 	I do not know if you have to give a privacy notice to the purchaser 	ARKAJ6PL85CME
Is there anything I should n't bring 	I do not know if there is anything you should n't bring 	AZLZA0Q87TJZO
How many days will it take for my package to be delivered 	I do not know how many days it will take for your package to be delivered 	APC99TPURUHR8
Can I have an independent inspection done on the car before I buy it 	I do not know if you can have an independent inspection done 	A2NI2HSU84PHJW
How does someone who holds two positions at the college enter their time 	I do not know how someone who holds two positions at the college enters their time 	A2MISBKRBT4AUA
What are we looking for as verification of registration with Selective Service 	I do not know what you are looking for as verification of registration with Selective Service 	A1J0GU26323WVA
What is the phone number of your locate chain store 	I do not know the phone number of our locate chain store 	A8F4B0854KTXO	
How do I get a mobile phone and set up voicemail 	I do not know how you get a mobile phone and set up voicemail	A23CTGXNDDW5LC
If I buy the item online , can I return it in store if I 'm not satisfied 	I do not know if you can return the item in store if you 're not satisfied 	A31A4YKVSOYRVS	
How does the process actually work 	I am not able to tell you how the process actually work 	A355BVFIOODRH2
Who said , ' Thou shall not be a perpetrator ; thou shall not be a victim ; and thou shall never be a bystander ' 	I do not know who said : ' Thou shall not be a perpetrator ; thou shall not be a victim ; and thou shall never be a bystander ' /	A31JM9RECQGYEX
My account is locked , how do I get back in 	I do not know how you get back in if your account is locked 	A2HKTM4Z8652
Can I please have help setting up my bluetooth 	I am not able to help you set up your bluetooth 	AE9M4Z1NCYSDM	
I wanted to buy this item but it 's sold out online . When might it be restocked 	I am not able to tell you when the sold out online item might be restocked	AYJGJAIY0EXW
Is it all possible to fulfill my request in a timely and reasonable fashion 	I do not know if it is all possible to fulfill your request in a timely and reasonable fashion	A23CTGXNDDW5LC	
I do not want to be in the customer rewards program anymore . how do I opt out 	I do not know how you opt out	A23CTGXNDDW5LC
How large should my water stand be 	I do not know how large your water stand should be 	A3RD486RQUI2XV
How can I send a gift or flowers to a patient 	I do not know how you can send a gift or flowers to a patient 	A3U0VQ420HIMQ0
Do you have places to eat , or can I bring my own food into the museum 	I do not know if we have places to eat , or if you can bring your own food into the museum 	A3I9FTHSULHPYS
When are salary increases effective 	I do not know when salary increases are effective	APF1EAZT104LQ
How many of these do you have in stock 	I do not know how many we have in stock 	A1YKWG46AWMPUX	
What happens if I want to come to the museum on a blackout date 	I do not know what happens if you want to come to the museum on a blackout date	A23CTGXNDDW5LC
Would HR Alternatives be actually replacing my current HR staff or management 	I do not know if HR Alternatives would be actually replacing your current HR staff or management 	A2HKTM4Z8652
Do you guys do price-matching 	I do not know if we do price-matching 	A31A4YKVSOYRVS	
How often are Travel Advice and Advisories pages revised 	I do not know how often Travel Advice and Advisories pages are revised 	A2D0IIX70FDQIW
Can I purchase the engagement ring in installments 	I do not know if you can purchase an engagement ring in installments 	A3SSJNH5SIZUPG	
Where is the best place to park 	I do not know where the best place to park is 	A2EJ7U3TZAKROG
Which browsers do you recommend 	I do not know which browser to recommend 	A2TP3K1THK6XRB
How do I get my money back if I used a check for the item I purchased and want to return 	I do not know how you get your money back if you used a check 	A3VV5FFG6GXE1S	
What are the hours of the Museum and the Glass Studio 	I do not know what the hours are of the Museum and the Glass Studio 	A2HKTM4Z8652
Can I take photos on the tour 	I do not know if you can take photos on the tour 	A2NI2HSU84PHJW
Are there designated smoking areas in the Zoo 	I do not know if there are designated smoking areas in the Zoo	A23CTGXNDDW5LC
What about the weather 	I do not know about the weather 	A13GUTDMGGZZDL
Can you tell me where my order is 	I am not able to tell you where your order is 	AJKA9BKC011F2
What is the definition of minimum wages 	I do not know the definition of minimum wages 	A2NI2HSU84PHJW
I have several accounts , can they be purged or deleted 	I do not know if your accounts can be purged or deleted 	APC99TPURUHR8
What can my family do at C'MON	I am not able to tell you what your family can do at C'mon 	AT7ADQKXKXEWY
Does Columbia provide fee waivers for the CSS Profile 	I do not know if Columbia provides fee waivers for the CSS Profile 	A1JBSFXMMRGSQD
How do bivalve shellfish reproduce 	I do not know how bivalve shellfish reproduce 	A1IPD4WBT3A5GG
What immunizations are required for sixth graders 	I do not know the required immunizations for sixth graders 	A2VIKCIM9TZL22
How does TurboTax work 	I do not know how TurboTax works 	APC99TPURUHR8
What should I pack for clothing , is there a dress code in the show rooms 	I do not know if there is a dress code in the show rooms 	A3RD486RQUI2XV
How much are entry tickets for the State Hermitage Museum 	I do not know the price of entry tickets for the State Hermitage Museum 	A2K9PB0U45O0MU
Do you offer any sort of military discount 	I do not know if we offer any sort of military discount 	A31A4YKVSOYRVS	
How long is the warranty on this 	I do not know how long the warranty is on this 	A3RD486RQUI2XV
When does overtime start accruing for part-time employees 	I do not know when overtime starts accruing for part-time employees	A1CMT9MVUO52VP
If Administrative & Professional -LRB- A&P -RRB- faculty move to a University Staff position can they retain A&P status 	I do not know if Administrative & Professional -LRB- A&P -RRB- faculty can retain A&P status if they move to a University Staff position 	A1X3SF2W1QQBY1
We would like to make reservations for a group of eight , can you reserve the table by the fireplace 	I am not able to reerve the table by the fireplace	A23CTGXNDDW5LC
What is a deductible/co pay/coinsurance , etc. . 	I do not know what deductible/co pay/co insurance is 	A2LQ9NP944M61Z
My item was damaged in the mail 	I am not able to assist you with your item damaged in the mail 	A2PKDWREQV1JTR
We are a family group of 5 wanting entrance tickets to the Vatican . 3 are over 18 and 2 under . It is unclear whether I should book for the under 18 separately as although I mentioned all 5 names in the group space , the quoted price seems to be only for the over 18 . Pls advise	I do not know if you should book for the under 18 separately 	A3UJE4WA5XADZS
Could you put this item on hold for me please 	I am not able to put this item on hold for you 	A2EAJXBORHT44T	
Do I need to include courses taken while I was in middle school/junior high school 	I do not know if you can include courses taken while you were in middle school/junior high school 	A1J0GU26323WVA
Are shoes required 	I do not know if shoes are required 	A2TP3K1THK6XRB
Does the online paycheck view take the place of my paper checks and check advices 	I do not know if the online paycheck view takes the place of your paper checks and check advices 	A16VTK6KZ1U69H
Do you carry other models from this brand 	I do not know if we carry another model from that brand 	AJNQ2PBD07FKE
Where can I get some puppets made 	I do not know where you can get some puppets made 	A18KR781AUQBA6
I need a copy of my contract please 	I am not able to give you a copy of your contract 	A9LX66EQWDRQ5	
Should an employer have a no dating policy 	I do not know if an employer should have a no dating policy 	AWAW665TQQP2F
Is this a rain or shine event 	I do not know of the event 	A3722NOMVUK89T
What is SMoCA Lounge 	I do not know what SMoCA Lounge is 	A7SXWHGK8B40R
Do you require SAT/ACT 	I do not know if we require SAT/ACT 	A3L8LSM7V7KX3T
Can I put my account on hold for a few months 	I am not able to put your account on hold for a few months 	A9LX66EQWDRQ5	
If the balance in my TravelBank exceeds my ticket price , what happens to the balance 	I do not know what happens to your balance if the balance in your TravelBank exceeds the ticket price 	A2EJ7U3TZAKROG
Does this store offer a layaway program 	I do not know if this store offers a layaway program 	ASFR82SJYMGNU
What is the ticketing policy for First Fridays 	I do not know the ticketing policy for First Fridays 	A2K9PB0U45O0MU
Can I schedule a payment arrangement 	I do not know if you can schedule a payment arrangement	A23CTGXNDDW5LC	
I 'm going overseas and I need to change my service 	I am not able to help if you are going overseas and need to change your service 	AE9M4Z1NCYSDM	
Do you have a restroom or a changing room 	I do not know if we have a restroom or changing room 	A1JBSFXMMRGSQD
Do you offer group rates for field trips 	I do not know the group rates for field trips 	A2NI2HSU84PHJW
Does Intel charge run-time fees or royalties for its libraries 	I do not know if Intel charges run-time fees or royalties for its libraries	A23OS0HQ12VVOR
How much would I have to pay to upgrade to first class 	I do not know how much you would have to pay to upgrade to first class 	AD9O852KPYLHY	
How do I check on the status of my order 	I do not know how you check on the status of your order 	A3RD486RQUI2XV
If my order has n't shipped yet can I add another item to it 	I do not know if you can add another item if your order has n't shipped yet 	A31A4YKVSOYRVS	
I will be coming straight from the airport . Are there lockers or some way to store my bag while I visit the Museum 	I do not know if there are lockers or some way to store your bag while you visit the Museum 	A116N2LEI6O7HB
Do you offer group discounts 	I do not know if we offer group discounts 	A3RO0QIXW4IX3Y
I 'd like to know the major differences between these two products 	I do not know the major differences between these two products 	A31A4YKVSOYRVS	
Can I use a detail of a CC0 image in my publication 	I do not know the details of a CC0 image in your publication 	A2NI2HSU84PHJW
What insurance information should I bring upon my visit to the hospital as an in patient 	I do not know what insurance information you should bring upon your visit to the hospital as a patient 	A8O98QNRG9SHV
What is my account balance 	I do not know what your account balance is 	A31A4YKVSOYRVS	
Can I pay by card and is there a minimum spend 	I do not know if you can pay by card or if there is a minimum spend 	A1X3SF2W1QQBY1
Where can I get copies -LRB- reproductions -RRB- of the Charters of Freedom 	I do not know where you can get copies -LRB- or reproductions -RRB- of the Charters of Freedom 	A2223XYV804AY7
Who provides care 	I do not know who provides care 	A1BWNS27NA1JAP
I need to change the date of my monthly payment from the 1st to the 15th of each month 	I am not able to change the date of your monthly payment from the 1st to the 15th of each month 	A3GNQDFPZALU92	
When can I apply for assistance 	I do not know when you can apply for assistance 	A3O4VPJT4GOBMB
What are the differences in the shipping prices and days 	I do not know the difference in shipping prices and days	A224I9B6RFJZEI	
Following discussions about a grievance , the employee walked out claiming that I forced them to resign . Should I be concerned	I do not know if you should be concerned	A23CTGXNDDW5LC
Where can I find my Jury ID and Group Number 	I do not know where you might find your Jury ID and Group Number	A13JQTLPWXZD6L
Do you offer any sort of discounts for customers on their birthday 	I do not know if we offer any sort of discounts for customers on their birthday 	A112W2FKT6UT62
I need to reset my username , can you help me with that 	I am not able to reset your username 	AQGBE43JMWHSR
If I place two orders separately will you combine shipping to the same address 	I do not know if two separate orders can combine to ship to the same address 	AE9M4Z1NCYSDM	
Can I purchase a right-hand-drive Kia 	I do not know if you can purchase a right-hand-drive Kia 	A1AF392CLGHH0X
How high are those Statewide Progressive Jackpots like Megabucks 	I do not know how high the Statewide Progressive Jackpots are 	A1XNCA1SVTT15B
What are the hours of operation 	I do not know the hours of operation 	A235UQRA8GE18X
This product did n't get to me in time and I needed it for an event , I need reimbursed	I am not able to reimburse you for the product not getting to you in time 	A3GNQDFPZALU92	
When is the current sale going to be ending 	I do not know when the current sale is going to end 	A3VV5FFG6GXE1S	
How can I learn more about the employee benefits offered by Fairfax County 	I do not know how you can learn more about the employee benefits offered by Fairfax County	ATQD23E8ESFSI
Can I join the union , if applicable , before getting hired 	I do not know if you can join the union , if applicable , before getting hired 	A3I9FTHSULHPYS
When should I submit my documents for the I-20 Certificate of Eligibility 	I do not know when you should submit your documents for the I-20 Certificate of Eligibility 	A1JBSFXMMRGSQD
Do you have classes for Adults 	I am not able to tell you if we have classes for Adults 	A2UBEPT605E8T2
How long does it take to update my specials 	I do not know how long it takes to update your specials	A23CTGXNDDW5LC
Can you provide a breakdown of how many DACA EADs expire in 2017 , 2018 , and 2019 	I am not able to provide a breakdown 	A13GUTDMGGZZDL
Whom can I contact with feedback about my hospital stay 	I do not know who you can contact with feedback about your hospital stay 	A3RD486RQUI2XV
Can I make this a recurring order on set dates 	I do not know if you can make this a recurring order on set dates 	A31A4YKVSOYRVS	
Can I have some phone numbers for use later to contact this office or the main office 	I do not know some phone numbers for use later to contact this office or the main office	A23CTGXNDDW5LC	
What if I do n't have my OHIO ID and password 	I do not know what to do if you do n't have your ID and password 	A2NI2HSU84PHJW
Is half or full board available 	I do not know if half or full board is available 	A2EJ7U3TZAKROG
What is CMA and what can my family do there 	I do not know what the CMA is 	A15UV2T9GKXSI4
I am a journalist researching a story 	I do not know about this topic 	A13GUTDMGGZZDL
Are they required to be potty trained 	I do not know if they are required to be potty trained 	A2K2MFQMN31DZ
What is Creative Commons Zero -LRB- CC0 -RRB- 	I do not know what the Creative Commons Zero -LRB- CCO -RRB- is 	A2K9PB0U45O0MU
What features are offered with your new product line 	I do not know features offered with new product line 	AJNQ2PBD07FKE
What are the monthly access charges for smartphones , tablets and mobile hotspots on the Verizon Plan , and why are some of them different 	I do not know the monthly access charges for smartphones , tablets , and mobile hotspots on the Verizon Plan , or why some of them are different 	APC99TPURUHR8
How can I become a member of the Wildlife Conservation Society	I do not know how you can become a member of the Wildlife Conservation Society 	A2TP3K1THK6XRB
It says it was delivered but nothing has arrived yet . Where is it 	I do not know where it is 	A1YKWG46AWMPUX	
Where can I do my banking , now that my former branch has closed down 	I do not know where you can do your banking now that your former branch has closed down 	A3GNQDFPZALU92	
How can I find a good all inclusive vacation package 	I do not know how you can find a good all inclusive vacation package 	A8F4B0854KTXO	
Is my membership tax deductible 	I do not know if your membership is tax deductible 	A2NI2HSU84PHJW
I have already been to Germany , can I use the same visa for a trip to another Schengen state 	I do not know if you can use the same visa for a trip to another Schengen state if you have already been to Germany 	AZLZA0Q87TJZO
Can you look for this in another color in the back 	I am not able to look for this in another color in the back	A23CTGXNDDW5LC	
Is it possible for my item to be delivered on the release date 	I do not know if the item will be delivered on the release date 	A1YKWG46AWMPUX	
If I want my product here by Friday , which shipping method should I select 	I do not know which shipping method you should select 	ASFR82SJYMGNU
Could I request a refund on the credit in my invoice 	I am not able to issue a refund on the credit in your invoice 	A9LX66EQWDRQ5	
When must an employer include the fair market value of an employee 's personal use of a company-provided cell phone in the employee 's taxable income 	I do not know when an employer must include the fair market value of an employee 's personal use of a company-provided cell phone in the employee 's taxable income 	A2NI2HSU84PHJW
Where can I change my password on the site 	I do not know where you can change your password on the site 	A31A4YKVSOYRVS	
What is not included in the definition of clothing 	I do not know what is not included in the definition of clothing 	A1JBSFXMMRGSQD
What is a ' Course ' 	I do not know what a Course is 	A18KR781AUQBA6
Is this the only package you offer 	I do not know if this is the only package we offer 	A8F4B0854KTXO	
Are there food and drinks provided for ArtScience Late 	I do not know if food and drinks are provided for ArtScience Late 	A1IPD4WBT3A5GG
What is the difference between Saver and Everyday Awards 	I do not know the difference between Saver and Everyday Awards 	A1JBSFXMMRGSQD
Where can I PICK UP TICKETS BEFORE THE PAVILION STAGE PERFORMANCE	I do not know where to pick up tickets before the pavilion stage performance 	A3GVKU8KSX3RZU
I ca n't find my bill due date 	I do not know the due date of your bill 	AEXWOFM1LGS6U
Is there a way to purchase postage using the website or mobile app so I do n't have to go out to the post office 	I do not know if there is a way to purchase postage on the website or mobile app 	AD9O852KPYLHY	
Does the definition of applicable clinical trial under FDAAA 801 only include studies conducted under an FDA Investigational New Drug Application -LRB- IND -RRB- or Investigational Device Exemption -LRB- IDE -RRB- 	I do not know if the definition of applicable clinical trial under FDAAA 801 only includes studies conducted under an FDA Investigational New Drug Application or Investigational Device Exemption 	A1JBSFXMMRGSQD
Last week I purchased a top for $ 50 dollars and now it 's on sale for $ 30 	I do not know what to do if you purchased a top for $ 50 dollar and now it 's on sale for $ 30 	ASFR82SJYMGNU
How do I use my Member Pass cards for my free museums admission and discounts 	I do not know how you use your member pass cards for free museum admission and discounts 	A2K2MFQMN31DZ
What is the construction happening at the Museum 	I do not know what the construction happening at the Museum is 	A1X3SF2W1QQBY1
I was wondering if your candies are made in nut-free facilities 	I am not able to tell you if our candies are made in nut free places	APF1EAZT104LQ
What does the 'D ' in D-Day mean 	I do not know what the 'D ' in D-Day means 	ARKAJ6PL85CME
When do I need to submit my claim form 	I do not know when you need to submit your claim form	ABWW1P7GZ4C0Z
I need a Notary Public , is there someone here at the college 	I do not know if there is someone here at the college 	A1XNCA1SVTT15B
Why are there ads in your app ? Is there a way for me to get rid of them 	I do not know why there are ads on the app or how to get rid of them 	A31A4YKVSOYRVS	
How do I get payroll to change my name 	I do not know how you can get payroll to change your name 	AT7ADQKXKXEWY
Can I get the red paint with the black stripes 	I do not know if you can get the red paint with the black stripes 	A9LX66EQWDRQ5	
Where is the zoo located 	I do not know where the zoo is located 	A16VTK6KZ1U69H
What other exhibits do you have at the Museum 	I do not know what other exhibits we have 	A13GUTDMGGZZDL
Are items ready to be shipped or made to order 	I do not know if items are ready to be shipped or made to order 	A1JBSFXMMRGSQD
Payment and pricing - are there any reduced tickets 	I do not know if there are any reduced tickets 	AT7ADQKXKXEWY
How many employees are in the National Park Service 	I do not know how many employees are in the National Park Service 	A16VTK6KZ1U69H
When will the new model be released 	I do not know when the new model will be released 	AD9O852KPYLHY	
Are there any fees for transfers between accounts 	I am not able to tell you if there are any fees for transfers between accounts	APF1EAZT104LQ
Do I have to offer the same benefits to all employees 	I do not know if you have to offer the same benefits to all employees 	A1JBSFXMMRGSQD
What is required for the issue or extension of a residence permit 	I do not know what is required for the issue or extension of a residence permit 	A1J0GU26323WVA
Is the museum available for event rental or weddings 	I do not know if the museum is available for event rental or weddings 	A2EJ7U3TZAKROG
I already have an AdWords company , why do I need you to manage my campaigns 	I do not know why you need me to manage your campaigns 	A2NI2HSU84PHJW
can I use a physical gift card as payment for an online order	I do not know if you can use a physical gift card as payment for an online order	A23CTGXNDDW5LC
Which museums are participating 	I do not know which museums are participating 	A2K9PB0U45O0MU
I think I accidentally selected the wrong size , how do I change my order 	I am not able to to change the size on your order 	AJNQ2PBD07FKE
What is your return policy 	I do not know what our return policy is 	A1J0GU26323WVA
What if my goods arrive broken 	I do not know what to do if your goods arrive broken 	APC99TPURUHR8
What products does CDW offer 	I do not know what products CDW offers 	A9LX66EQWDRQ5
Is there any way my rate can be lowered 	I am not able to tell you if there is any way your rate can be lowered 	A3G2FBKYCRD5Q8	
Can I preorder these televisions 	I do not know if you can preorder the televisions 	AD9O852KPYLHY	
What are the hospital visiting hours & policies 	I do not know what the hospital visiting hours & policies are 	A1Z9FHDWNXG2SK
Are baby strollers permitted in the Museum 	I do not know if baby strollers are permitted in the Museum 	A234VIHHUHPZG5
What benefits does your store offer if I apply for store credit card 	I do not know what benefits our store offers if you apply for the store credit card 	A3GNQDFPZALU92	
How do you decide how much to charge for shipping 	I do not know how we decide how much to charge for shipping	A23CTGXNDDW5LC	
Is your company offering any deals to new customers at the moment 	I do not know if our company is offering any deals to new customers at the moment 	A185P3B2MC2K83
What happens if I have a lapse in coverage in 2015 	I do not know what happens if you have a lapse in coverage in 2015 	A3RD486RQUI2XV
Will I have to pay a fee if I cancel my subscription early 	I do not know if you will have to pay a fee 	AMW07CJC3OJIB
What is the difference between Pre-Ballet and ballet 	I do not know the differences between Pre-Ballet and ballet 	A2K9PB0U45O0MU
Can I see the animals being fed 	I do not know if you can see the animals being fed 	A13GUTDMGGZZDL
Do I have to be a MileagePlus member to book flights on united.com 	I do not know if you have to be a MileagePlus member to book flights on united.com 	A2UBEPT605E8T2
How do I obtain warranty support on my AT&T product 	I do not know how to obtain warranty support on my AT&T product 	A2NI2HSU84PHJW
Does SAM have a coat check 	I do not know if SAM has a coat check 	A2EJ7U3TZAKROG
Can I speak with the bot that I was speaking to earlier today 	I am not able to let you speak with anyone else 	AD9O852KPYLHY	
Do you guys have a mobile app 	I do not know if we have a mobile app 	A2IXBTOWQRCLPZ	
Where do I go to change my shipping address 	I do not know where you go to change your shipping address 	A325WS381BHOHH	
What does the ' autoPROS Certified Warranty ' include 	I do not know what the ' autoPROS Certified Warranty ' includes 	A2D0IIX70FDQIW
Who should I address my cover letter to 	I do not know to whom you should address your cover letter 	A1HLG5NN2I16GN
Are there food and drinks provided for Conversations 	I do not know if there are food and drinks provided for conversations 	A2VIKCIM9TZL22
Do n't the animals get cold in the winter 	I do not know if animals get cold in the winter 	A2K9PB0U45O0MU
What fish species do you study at the NEFSC 	I do not know what fish species I study at the NEFSC 	A2RHBR7XZGUI1C
How do I view my membership details such as level , expiration date , and reciprocal membership privileges 	I do not know how you can view your membership details such as level , expiration date , and reciprocal membership privileges 	A2K9PB0U45O0MU
Does ARIA Offer a Day Pass to the Pool Area for Non-Guests 	I do not know if ARIA offers a Day Pass to the Pool Area for Non-Guests 	A31JM9RECQGYEX
Do you offer classes for adults 	I do not know if we offer classes for adults 	A3SS1F4F3JE7CU
How long is my Member Pass valid 	I do not know how long your member pass is valid 	A27MJOV91GA8R3
Can you connect me to someone in billing 	I am not able to connect you to someone in billing 	ASFR82SJYMGNU
Are there restaurants in the museum 	I do not know if there are restaurants in the museum 	A11IEP7J8XSE1C
What is your refund policy 	I do not know the refund policy 	AYJGJAIY0EXW
Why would I need to have the Enhanced Service and what does it cost 	I do not know why you would need to have the Enhanced Service and what it cost	ATQD23E8ESFSI
Is it possible to visit with two groups at the same time 	I do not know if it 's possible to visit with two group at the same time 	A18RMWE4BKHG6R
What is the deadline for registering my clinical trial in clinicaltrials.gov 	I do not know the deadline for registering your clinical trial in clinicaltrials.gov	A2K9PB0U45O0MU
Ca n't find the answer to your question 	I am not able to help if you ca n't find the answer to our question 	A1JBSFXMMRGSQD
What is SB 1301 	I do not know what SB 1301 is 	A2HKTM4Z8652
How do I find out when my court date is 	I do not know how you find out when your court date is 	A235UQRA8GE18X
Do homeschooled students self-report coursework and grades 	I do not know if homeschooled students self-report their coursework and grades 	A2LQ9NP944M61Z
What do I do if I need to drop a class	I do not know what you do if you need to drop a class	A23CTGXNDDW5LC
My wallet was stolen ! Can someone else use my membership 	I do not know whether someone else can use your membership 	A3U6CLX7HD0SMF
Are there other ' spy ' museums 	I do not know if there are other spy museums 	A1JBSFXMMRGSQD
Is there unstructured time 	I do not know if there is unstructured time 	A2K2MFQMN31DZ
I 'd like to sign up for this membership program , how do I do this 	I do not know how you would sign up for this membership program 	A30YFEIPGXNWJL
What day is my next payment due 	I do not know when your next payment is due 	A39MLQY9HOG1S6
Is the enamel surface scratch-resistant 	I do not know if the enamel surface is scratch-resistant 	A2HKTM4Z8652
How far in advance can I reserve a museum visit 	I do not know how far in advance you can reserve a museum visit 	A1X3SF2W1QQBY1
Can we take photographs 	I do not know if you can take photographs 	A3I9FTHSULHPYS
How can I add an item to my order 	I am not able to add an item to your order 	A1YKWG46AWMPUX	
Can I access my car once in the Zoo 	I do not know if you can access your car once in the zoo 	A2NI2HSU84PHJW
We live outside of the city of Grand Rapids . Can my child still attend 	I am not able to tell you if your child can still attend	APF1EAZT104LQ
Where is ' Meet the Animals ' 	I do not know where ' Meet the Animals ' is 	A8O98QNRG9SHV
Can I sit in on my child 's private music lesson 	I do not know you can sit in on your child 's private music lesson 	A16184N1RO5OJV
Has your company ever been hacked and had customer data stolen 	I do not know if my company has ever been hacked and had customer data stolen	A23CTGXNDDW5LC
May I have permission to link to your websites 	I am not able to give you permission to link to our websites 	A2VIKCIM9TZL22
Does the exemption apply to repairs , alterations , or items for rent 	I do not know if the exemption applies to repairs , alterations , or items for rent 	A3SS1F4F3JE7CU
What about restroom facilities 	I do not know about restroom facilities 	A2LQ9NP944M61Z
What subjects do you offer 	I do not know what subjects we offer 	A1J0GU26323WVA
My package arrived damaged ; is there anything you can do about that 	I am not able to do anything about your damaged package 	A3RD486RQUI2XV
WHAT IS THE COST OF ADMISSION TO MUSEUM	I do not know the cost of the admission to the museum 	A2LQ9NP944M61Z
How does ITT 's closure impact my federal Direct Loan limitations 	I do not know how ITT 's closure impacts your federal Direct Loan limitations 	A7SXWHGK8B40R
What happens if I get sick in North Korea 	I do not know what happens if you get sick in North Korea 	A16NITTBMCSN0V
What if I have been home schooled 	I do not know what occurs if you have been home schooled 	A1JBSFXMMRGSQD
Would it be possible to get my purchase gift wrapped 	I do not know if you can get it gift wrapped 	A113OGTB578EF6	
Can a purchase a monthly pass for the train 	I do not know if you can purchase a monthly pass for the train 	A31A4YKVSOYRVS	
How can I send an email with a question to Chrysler Capital 	I do not know how you can send an email with a question to Chrysler Capital 	A2EJ7U3TZAKROG
What types of scholarship are available 	I do not know what types of scholarship are available 	A2NI2HSU84PHJW
How to renew/upgrade my membership 	I do not know how to renew/upgrade your membership 	A2NI2HSU84PHJW
Does this car have a back up camera 	I do not know if this car has a back up camera 	A9LX66EQWDRQ5	
How can I book a group visit 	I do not know how you can book a group visit 	A3G2FBKYCRD5Q8
How can I reprint my check stub 	I do not know how you can reprint your check stub 	A1S8DYWNS59XWB
What services do you provide for home health 	I do not know what services we provide for home health	APF1EAZT104LQ
Are extra beds/rollaway beds available 	I do not know if extra beds or rollaway beds are available 	A13GUTDMGGZZDL
Can I get my friend 's wristband 	I do not know if you can get your friend 's wristband 	A2HKTM4Z8652
What if I get more than one bill 	I do not know what you should do if you get more than one bill 	A325WS381BHOHH
What is the difference between this insurance plan and your newest one 	I do not know the difference between this insurance plan and the newest one 	A30YFEIPGXNWJL
Can adults try on replica dress too 	I do not know if adults can try on the replica dress too 	A5VBIZ2KIQ1R8
How do I get to the Museum by bus , subway , or car 	I do not know how to get to the Museum by bus , subway , or car 	APC99TPURUHR8
Can you tell me if there is any way I can save some money on my monthly services 	I am not able to tell you if there is any way you can save some money on your monthly services	A23CTGXNDDW5LC	
Can I use my device outside the US 	I do not know if you can use your device outside the US 	A235UQRA8GE18X
Can I assign my own tracking number for my shipment 	I do not know if you can assign your own tracking number for your shipment 	A11TABPKSVOOFT
If I buy 100 or more , can I get a discount 	I do not know if you get a discount if you buy 100 or more 	A2EAJXBORHT44T	
How do I submit a claim 	I do not know how you can submit a claim 	A3VV5FFG6GXE1S	
Can I purchase an item and send it as a gift 	I do not know if you can purchase an item and send it as a gift 	A31A4YKVSOYRVS	
How does the radio work 	I do not know how the radio works 	AE9M4Z1NCYSDM	
Is there parking available for RVS	I do not know if there is parking available for RVs 	AZLZA0Q87TJZO
Do you offer gift wrapping 	I do not know if we offer gift wrapping 	A1OPGPTQJ48XOY	
Can you email me more information 	I am not able to email you more information 	A185P3B2MC2K83
Can we reserve a table in the restaurant 	I do not know if you can reserve a table at the restaurant 	A3U0VQ420HIMQ0
What is the cheapest gym membership you offer 	I do not know what the cheapest gym membership we offer is 	A3GNQDFPZALU92	
Can I change the amount of emails I receive	I am not able to help with changing your email preferences 	A39MKVROUZ1UWR
How does using CarHub Connect make my life easier 	I do not know how using CarHub Connect makes your life easier 	A7SXWHGK8B40R
Where can I find Trinity 's current vacancies advertised 	I do not know where you can find Trinity 's current vacancies advertised 	A16NITTBMCSN0V
How long will the check in process take once I arrive 	I do not know how long the check in process will take once you arrive 	A3GNQDFPZALU92	
Can I purchase a Chevrolet directly from the factory 	I do not know if you can purchase a Chevrolet directly from the factory 	A9LX66EQWDRQ5
What are the rental rates on your moving trucks 	I am not able to tell you the rental rates on our moving trucks 	AE9M4Z1NCYSDM	
Do you send members any coupons 	I do not know if we send members any coupons 	ASFR82SJYMGNU
I need help combining shipping for my items , how do I do this 	I am not able to tell you how to combine shipping for your items	AYJGJAIY0EXW
What is the most-visited national park 	I do not know what the most-visited national park is 	A26XN1TM6CV01T
Can you change my shipping method from Fedex Ground to Fedex Home Delivery so that my package will be delivered on Saturday 	I am not able to change your shipping method	APF1EAZT104LQ
How do I cancel my fruit of the month subscription 	I do not know how to cancel your fruit of the month subscription 	A1YKWG46AWMPUX	
What should I do if I receive a Jury Summons in the mail 	I do not know what you should do if you receive a Jury Summons in the mail 	A3RD486RQUI2XV
How is Dumping or Subsidization remedied 	I do not know how dumping or subsidization remedied 	A9LX66EQWDRQ5
What is the status of my order 	I do not know what the status of your order is	APF1EAZT104LQ
What is the most popular item purchased 	I do not know what the most popular purchased item is 	A31A4YKVSOYRVS	
I Am Disabled ; will I be able to go on a stadium tour at Emirates Stadium	I do not know if you will be able to go on a stadium tour at emirates stadium	A23CTGXNDDW5LC
How do I cancel a registration 	I do not know how to cancel a registration 	A13GUTDMGGZZDL
What subjects and qualifications can I study 	I do not know what subjects and qualifications you can study 	A3B2YRXL26RPVH
Can I touch the art 	I do not know if you can touch the art 	A2NI2HSU84PHJW
What does Thought Catalog Books stand for 	I do not know what Thought Catalog Books stands for	APF1EAZT104LQ
I cancelled my order but I am still seeing a charge in my checking account 	I do not know if you cancelled your oder but you are still seeing a charge in your checking account 	ASFR82SJYMGNU
What is the delivery method for my American Friends membership card 	I do not know what the delivery method is for your American Friends membership card 	A1JBSFXMMRGSQD
What Kind of Emergency Care is Available 	I do not know what kind of emergency care is available 	A1R1J3GL0YP7DJ
Who in Personnel should I contact about my appointment 	I do not know who you should talk to about your appointment 	A2K9PB0U45O0MU
What is your process for implementation 	I am not able to tell you what our process for implementation is 	A116N2LEI6O7HB
Does an employer have to pay its employees overtime if they work the night shift or the graveyard shift 	I do not know if an employer has to pay its employees overtime if they work the night shift or the graveyard shift ,	A3U0VQ420HIMQ0
What is XFINITY WiFi 	I am not able to tell you what Xfinity WiFi is 	APF1EAZT104LQ
Can I use my debit card for the transaction 	I do not know if you can use your debit card for the transaction 	A9LX66EQWDRQ5	
Are there ways to save on my admission cost 	I do not know if there are ways to save on your admission cost	A23CTGXNDDW5LC
When should I first try nursing my baby 	I do not know when you should first attempt nursing your baby 	A16NITTBMCSN0V
How many campers are in a group 	I do not know how many campers are in a group 	A2NI2HSU84PHJW
Can I clean my Staub products in the dishwasher 	I do not know if you can clean your Staub products in the dishwasher 	A3P1SDBXCNU6C
I would like to know what your refund policy is 	I do not know what our refund policy is 	AMYD8PNSBQ7C2
What are the benefits of getting the card 	I do not know the benefits of getting the card 	A2K9PB0U45O0MU
Please reverse yesterday 's charge 	I am not able to reverse yesterday 's charge	A23CTGXNDDW5LC	
How do I upgrade my device in the My Verizon app 	I do not know how to upgrade your device in the My Verizon app 	A2K9PB0U45O0MU
Do I have to sign a contract to have your service 	I do not know if you have to sign a contract to have our service 	ASFR82SJYMGNU
Can you please help me update my mailing address on my account 	I do not know how to update your mailing address on your account 	A3RD486RQUI2XV
Can I sit in the exit row 	I do not know if you can sit in the exit row 	A1X3SF2W1QQBY1
Does my child need a separate visa to travel with me 	I do not know if your child needs a separate visa to travel with you 	AZLZA0Q87TJZO
I have only 15 children , but each of them has 1 parent -LRB- a maximum of 30 people total in the group -RRB- . Can they all participate without the parents paying extra admission 	I do not know if they can all participate without the parents paying extra admission 	A13GUTDMGGZZDL
What extra fees will I have to pay if I decide to purchase the car 	I do not know the extra fees you will have to pay if you decide to purchase the car 	A2K9PB0U45O0MU
Do you have any discounts available 	I do not know if we have any discounts available 	A325WS381BHOHH	
Can I delay the shipment so it arrives closer to Christmas 	I do not know if you can delay the shipment so it arrives closer to Christmas 	A2IXBTOWQRCLPZ	
When will my magic bands ship 	I do not know when your magic bands ship 	AD9O852KPYLHY	
I 'm having trouble opening some of the attachments/links on the website 	I am not able to help you open some of the attachments/links on the website 	A1JBSFXMMRGSQD
IS AIRFARE INCLUDED IN THE PACKAGE PRICING	I do not know if airfare is included in the package pricing 	A1X3SF2W1QQBY1
Is there an option to renegotiate the terms of our mortgage loan 	I do not know if there is an option to renegotiate the terms of your mortgage loan 	A31A4YKVSOYRVS	
What do I need to know to be prepared for a tsunami 	I do not know what you need to know to be prepared for a tsunami 	A3B2YRXL26RPVH
What if I have trouble using your online ticketing 	I do not know what you should do if you have trouble using our online ticketing 	A2VIKCIM9TZL22
How do we determine ' primary duty ' 	I do not know how you determine primary duty	APF1EAZT104LQ
Do you offer free installation with the purchase of appliances 	I do not know if we offer free installation with the purchase of appliances 	AE9M4Z1NCYSDM	
Can I choose extra special equipment with my reservation 	I do not know if you can choose extra special equipment with your reservation 	A9LX66EQWDRQ5
Is there a membership fee 	I do not know if there is a membership fee 	APC99TPURUHR8
I would like to deactivate my account 	I am not able to deactivate your account 	AMELZJ4P3IIJH
How are health plan identifiers -LRB- HPIDs -RRB- handled for wrap plans 	I do not know how health plan identifiers -LRB- HPIDs -RRB- are handled for wrap plans 	A2ZBJWQ9ZZHYYI
What specials are you running right now for family 's 	I am not able to tell you the specials	APF1EAZT104LQ
Do I need to purchase extra insurance 	I do not know if you need extra insurance	APF1EAZT104LQ	
I receive personal information from someone who applies for financing for the purchase of a car . After processing the application , I decide not to accept the application for credit . I have no plans to share this person 's information , other than as required by law . Do I have to give this individual a privacy notice 	I do not know if you have to give this individual a privacy notice 	A1XNCA1SVTT15B
How old do I need to be to volunteer 	I do not know how old you need to be to volunteer 	A1AF392CLGHH0X
How do I check on my order 	I do not know how to check on your order 	A9LX66EQWDRQ5	
How long should we plan on visiting 	I do not know how long you should plan on visiting 	A7SXWHGK8B40R
I need to avoid gluten . What can I eat 	I do not know what you can eat if you need to avoid gluten 	A3RD486RQUI2XV
What is Cinépolis Junior	I do not know what Cinepolis Junior is 	A1XNCA1SVTT15B
Do I need to show my credit card to the driver 	I do not know if you need to show your credit card to the driver 	AD9O852KPYLHY	
Will the zoo accept an animal I can not care for	I do not know if the zoo will accept an animal 	A13GUTDMGGZZDL
hat do I need to become a certified user 	I do not know what you need to become a certified user 	A3R71HP45TBQ7O
What 's involved with financing or leasing a new vehicle 	I do not know what 's involved with financing or leasing a new vehicle	A23CTGXNDDW5LC
What if we do n't want anything too difficult , fancy or choreographed 	I am not able to help you if you do n't want anything too difficult , fancy or choreographed 	A7SXWHGK8B40R
How does a group plan its visit 	I do not know How a group plans its visit	ATQD23E8ESFSI
How come my promo code does not work 	I do not know why your promo code does n't work 	A2NI2HSU84PHJW
Please tell me my balance due 	I do not know your balance due 	A1YKWG46AWMPUX	
What happens with a delayed arrival time 	I do not know what happens with a delayed arrival time 	A2VIKCIM9TZL22
Could you please help me create an online account 	I am not able to help you create an online account 	A9LX66EQWDRQ5	
Can registered domestic partners file federal tax returns using a married filing jointly or married filing separately status 	I do not know if registered domestic partners file federal tax returns using a married filing jointly or married filing separately status 	A8O98QNRG9SHV
Do you rent studio space for rehearsals 	I do not know if we rent studio space for rehearsals 	A2K2MFQMN31DZ
Can I import alcohol beverages -LRB- such as rum -RRB- made in Cuba into the United States 	I do not know how you can import alcohol beverages -LRB- such as rum -RRB- made in Cuba into the United States 	A2K9PB0U45O0MU
Can I make an appointment to tour your wedding venue 	I am not able to make an appointment to tour our wedding venue 	A2EAJXBORHT44T	
How soon will my order be shipped 	I do not know how soon your product will be shipped 	A2CEGV4ZIZWRKY	
Can I make a restaurant reservation over the phone 	I do not know if you can make a restaurant reservation over the phone 	A8F4B0854KTXO	
Is there a list of collection works presently on view at the Museum 	I do not know if there is a list of collection works presently on view at the Museum 	A3SS1F4F3JE7CU
Is there a restaurant or café at the AD&A Museum 	I do not know if there is a restaurant or cafe at the AD&A Museum 	A1A0PNOBFTTHGP
When did the Museum open 	I do not know when the Museum opened 	A2VIKCIM9TZL22
Can I name my galaxies 	I do not know IF YOU name my galaxieS	ATQD23E8ESFSI
Are there minibars in the rooms 	I do not know if there are minibars 	A325WS381BHOHH
I think I 'm eligible to buy my Rock Hall admission tickets at a discount . How can I do that 	I do not know how to do that 	A2NI2HSU84PHJW
What is the thin black line across the image 	I do not know what the thin black line across the image is 	A3U0VQ420HIMQ0
What is Intel ® Threading Building Blocks -LRB- Intel ® TBB -RRB- 	I do not know what Intel ® Threading Building Blocks -LRB- Intel ® TBB -RRB- is 	ABWW1P7GZ4C0Z
How does it help me find the right candidates 	I do not know how does it help you find the right candidates 	A3SS1F4F3JE7CU
When will you get this item back in stock 	I do not know when this item will be back in stock 	AD9O852KPYLHY	
Does the lawn pass include access to MYSTERYLAND USA	I do not know if the lawn pass includes access to mysteryland usa 	A2K9PB0U45O0MU
Where can I purchase this specific product besides online 	I do not know where you can purchase that specific product besides online	AYJGJAIY0EXW
How long does it take to update my payment information 	I do not know how long it takes to update your payment information 	A185P3B2MC2K83
Why is it important to separate Federal Reserve monetary policy decisions from political influence 	I do not know why it is important to separate Federal Reserve monetary policy decisions from political influence 	A1J0GU26323WVA
I need to close my account 	I am not able to close your account 	A31A4YKVSOYRVS	
I just placed my order . Can I add another item to it	I do not know if you can add another item to an existing order 	A2D0IIX70FDQIW
What are some of the benefits for APC volunteers 	I do not know what the benefits are for APC volunteers 	A3LA5P3N3KI8U7
What records does the Occupational Safety and Health Administration -LRB- OSHA -RRB- require an employer to keep 	I do not know what records the Occupational Safety and Health Administration -LRB- OSHA -RRB- requires an employer to keep 	A2HKTM4Z8652
Can I change my award ticket 	I do not know if you can change your award ticket 	A13GUTDMGGZZDL
Can I request a quote 	I do not know if you can request a quote 	A31A4YKVSOYRVS	
What is the difference between Leave Without Pay -LRB- LWOP -RRB- and Absence Without Approved Leave -LRB- AWOL -RRB- 	I do not know the difference between Leave Without Pay -LRB- LWOP -RRB- and Absence Without Approved Leave -LRB- AWOL -RRB- 	A30YFEIPGXNWJL
What do I need to produce to collect my race pack	I do not know what you need to product to collect your race pack 	A3U0VQ420HIMQ0
Do you have discounts for admission 	I do not know if we have discounts for admission 	A2HKTM4Z8652
What is your opening hours 	I do not know our opening hours 	A2IXBTOWQRCLPZ	
What training is available in PiMS 	I do not know what training is available in PiMS 	A1AF392CLGHH0X
What employer actions are prohibited by the Occupational Safety and Health Administration -LRB- OSHA -RRB- 's Whistleblower Statute 	I do not know anything about the Occupational Safety and Health Administration Whistleblower Statute 	A2K9PB0U45O0MU
When is the best time to visit 	I do not know when the best time to visit is 	AI3HPZQC9GMBY
When applying for a US passport renewal , will my old passport be returned to me 	I do not know if your old passport will be returned to you when applying for a US passport renewal 	A2EJ7U3TZAKROG
Should employers use questionnaires or computer software to sort through online job applications 	I do not know if employers should use questionnaires or computer software to sort through online job applications 	A3RD486RQUI2XV
What kind of dance flooring is used 	I do not know what kind of dance flooring is used	APF1EAZT104LQ
Can I lawfully terminate an employee for Absenteeism	I do not know if you can lawfully terminate an employee for absenteeism 	A13GUTDMGGZZDL
How long do I have to return an item 	I do not know how long you have to return an item 	AD9O852KPYLHY	
May I take photographs 	I do not know if you can take photographs 	A13GUTDMGGZZDL
What is the credit card number you have in my file 	I do not know what credit card number is on your file 	A3722NOMVUK89T	
What exactly does the warranty cover 	I do not know what the warranty covers 	AE9M4Z1NCYSDM	
Where on the bill does it show my device payment line credits and charges 	I do not know where on the bill it shows device payment line credits and charges 	A2ZBJWQ9ZZHYYI
Can you reduce shipping by removing the packaging of the item 	I am not able to reduce shipping by removing the packaging of the item 	AQLHX3G8KP4TS
How long will it take for my package to arrive 	I do not know how long it will take for your package to arrive 	A3SSJNH5SIZUPG	
I changed to the commercial version of hulu but some shows have more commercials than others , why is that 	I do not know why the commercial version of hulu has some shows with more commercials than others 	AE9M4Z1NCYSDM	
I need to put a lot of new info into my account , can you do it for me or do I have to type it all in online 	I am not able to do it for you	A23CTGXNDDW5LC	
How do I reprint my tickets 	I do not know how you reprint your tickets	A23CTGXNDDW5LC
Do provisions of the federal tax law such as section 66 -LRB- treatment of community income -RRB- and section 469 -LRB- i -RRB- -LRB- 5 -RRB- -LRB- $ 25,000 offset for passive activity losses for rental real estate activities -RRB- that apply to married taxpayers apply to registered domestic partners 	I do not know if provisions of the federal tax law such as section 66 -LRB- treatment of community income -RRB- and section 469 -LRB- i -RRB- -LRB- 5 -RRB- -LRB- $ 25,000 offset for passive activity losses for rental real estate activities -RRB- that apply to married taxpayers apply to registered domestic partners 	AJ7E01X4TAGHL
Will an invoice be included with my order 	I do not know if an invoice will be included 	A3722NOMVUK89T
Am I allowed to fly with a hedgehog in cabin 	I do not know if you are allowed to fly with a hedgehog in cabin 	A3GNQDFPZALU92	
Can I bring my class or camp group for a visit 	I do not know if you can bring your class or camp group for a visit 	A3RD486RQUI2XV
Can I bring my car club 	I do not know if you can bring your car club 	A1X3SF2W1QQBY1
What is the Gift Shop 's return policy 	I do not know the Gift Shop 's return policy 	A7SXWHGK8B40R
Will my return shipping cost be deducted from my refund 	I do not know if your return shipping cost will be deducted from your refund 	ASFR82SJYMGNU
Do you have any deals going on right now 	I do not know if we have any deals going on right now 	A31A4YKVSOYRVS	
How do I set up an online bridal registry 	I am not able to tell you how to set up an online bridal registry 	AE9M4Z1NCYSDM	
Be Prepared for Changing Weather	I am not able to be prepared for changing weather 	A3EJ2U51X7CLYW
How many items does the curated box come with 	I do not know how many items the curated box comes with	AYJGJAIY0EXW
Is there anywhere indoors to eat our picnic 	I do not know if there is anywhere indoors to eat your picnic 	A355BVFIOODRH2
Will I enjoy this tour even if I 'm not a country music fan 	I do not know if you will enjoy this tour even if you 're not a country music fan 	A9LX66EQWDRQ5
Does ICE 's policy sensitive locations policy remain in effect 	I do not know if ICE 's policy sensitive locations policy remain in effect 	A1J0GU26323WVA
Can you please cancel my order 	I am not able to cancel your order 	AE9M4Z1NCYSDM	
Where do we meet if we already have tickets 	I do not know where you meet if you already have tickets 	A1J0GU26323WVA
What if I have operations in multiple states 	I do not know what if you have operations in multiple states 	A3SS1F4F3JE7CU
How do I book a place on the Zoo Academy 	I do not know how you book a place on the Zoo Academy 	A16VTK6KZ1U69H
Can I use multiple coupons 	I do not know if you can use multiple coupons 	A31A4YKVSOYRVS	
What is the Subaru Guaranteed Trade-In Program 	I do not know what the Subaru Guaranteed Trade-In Program is 	A13GUTDMGGZZDL
How do I access XFINITY WiFi 	I do not know how you access XFINITY WiFi 	A2NI2HSU84PHJW
Does the number of travelers I choose limit my fare choices 	I do not know how the numbers of travelers you choose limits your fare choices 	A13GUTDMGGZZDL
Can I bring my dog/pet 	I do not know if you can bring your dog/pet 	A3RD486RQUI2XV
Are ZOOZIL EBOOKS compatible with other EREADERS	I do not know if Zoozil ebooks are compatible with other ereaders 	A31JM9RECQGYEX
Can you please reactivate my account 	I am not able to reactivate your account 	AD9O852KPYLHY	
I Have An Idea For A NYMCER Program , Who Should I Contact 	I do not know who you should contact 	A13GUTDMGGZZDL
Who do I call to stop telemarketing calls 	I do not know who you call 	A1F46RJTOXQM4J
Can I transfer miles to someone else 	I do not know if you can transfer miles to someone else 	A9LX66EQWDRQ5	
Who operates the Web site 	I do not know who operates the Web site 	A2NI2HSU84PHJW
Can I add insurance or other equipment protection options for a device I purchased under a device payment agreement 	I do not know if you can add insurance or other equipment protection options for a device I purchased under a device payment agreement 	A2NI2HSU84PHJW
How much is general admission , and what does it include 	I do not know how much general admission is , or what it includes 	AISE949ZZN8HA
I 'd like to close my account please 	I am not able to help you close your account 	A398I2WV28FA5P	
How do I get on your mailing list 	I do not know how you get on our mailing list	A23CTGXNDDW5LC	
Are there plenty in stock or can I wait a week 	I do not know if there are plenty in stock or if you can wait a week 	ASFR82SJYMGNU
I am a classroom teacher/homeschool educator who likes to bring my students to the museum for field trips and education programs . How does the admission impact our visits 	I do not know how the admission impacts your visits 	A7SXWHGK8B40R
Do I need a partner 	I do not know if you need a partner 	A3RD486RQUI2XV
Does the museum have a cloakroom/lockers -LRB- where can I leave my bags -RRB- 	I do not know if the museum has a cloakroom/lockers where you can leave your bags 	A3R71HP45TBQ7O
I am filing my 2016 U.S. tax return from a foreign country and am eligible for the automatic 2-month extension . Does the IRS need to receive my return by June 15 , 2017 , or can it just be postmarked by June 15 , 2017 	I do not know if the IRS needs to receive your return by June 15 , 2017 	A2NI2HSU84PHJW
Is there any way I can get an extension on my bill 's due date 	I do not know if there is any way you can get an extension on your bill 's due date 	A31A4YKVSOYRVS	
Will my insurance rates go up if I get into an accident 	I do not know if your insurance rates will go up if you get into an accident 	A2IXBTOWQRCLPZ	
What do I need to know about driving off road in national parks 	I do not know about driving off road in national parks 	A1XNCA1SVTT15B
When can I expect my package to arrive 	I do not know when you can expect your package to arrive 	AE9M4Z1NCYSDM	
Where do I go for classes 	I do not know whre you go for classes 	A13GUTDMGGZZDL
Do I need anything besides a Minecraft : Education Edition license to play 	I do not know if you need anything additional 	A3LA5P3N3KI8U7
How do I remove my drawer	I do not know how you remove your drawer 	A16VTK6KZ1U69H
What is my discount 	I do not know your discount 	A7SXWHGK8B40R
Are registered domestic partners each entitled to half of the credits for income tax withholding from the combined wages of the registered domestic partners 	I do not know if registered domestic partners are each entitled to half the credits for income tax withholding from the combined wages of the registered domestic partners 	A1JBSFXMMRGSQD
Do you have the item I want in my size 	I do not know if we have the item you want in your size 	A325WS381BHOHH	
Explain to me the benefits of your current membership program 	I am not able to explain the benefits of your current membership program 	ASFR82SJYMGNU
How do I find out how much has been paid for member 's Medicaid services 	I do not know how you find out how much has been paid for member 's Medicaid services 	AFS36YMNN8A2J
Do you provide a discount for educators 	I do not know if we provide a dicount for educators 	AD9O852KPYLHY	
Where do I file a civil case 	I am not able to give you specific details about civil cases 	A1YCGICA8XCNBH
