Why is the duration calculated when I apply for leave different to my hours of work 	I do not know why the duration calculated when you apply for leave is different from work yours 	A8O98QNRG9SHV
Where do I go to change my beneficiaries 	I do not know where you go to change your beneficiaries 	A3G2FBKYCRD5Q8
What are the terms of my contract 	I do not know the terms of your contract 	A1HQRT1UG6ERGL
Does Zoo College provide me with standard college or university credits toward my degree 	I do not know if Zoo College provides standard college or university credits toward your degree 	A2NI2HSU84PHJW
Can you help me take this to my car 	I am not able to help take this to your car 	AE9M4Z1NCYSDM	
Why can the system build such a profile , or what is the scientific foundation of it 	I do not know why the system builds such a profile or the scientific foundation of it 	A2K9PB0U45O0MU
Do you all have this dress in a size 6 	I do not know if we have this dress in a size 6 	A31A4YKVSOYRVS	
When is my start date 	I do not know the start date 	A2NI2HSU84PHJW
Do you have any special offers on items this month 	I do not know if we have any special offers on items this month 	ASFR82SJYMGNU
I have a membership , but never used it online . What should I do 	I do not know what you should do if you have a membership but never used it online 	AZLZA0Q87TJZO
How do I order a card for my spouse 	I do not know how to order a card for your spouse 	AJKA9BKC011F2
Can I still buy tickets online 	I do not know if you can still buy tickets online 	A13GUTDMGGZZDL
I do n't see the Windows 8.1 or Windows 10 edition I 'm looking for . Where else should I check 	I do not know where else you should check	A23CTGXNDDW5LC
Did my card go through	I do not know if your card went through 	A1YKWG46AWMPUX	
Are your prices the same in the store and online , or do you run different specials online 	I do not know if we have different specials online 	3YO4AH2FPDCDSSQJXKZ2Y94PBUCQ0A
Why am I being charged extra for this 	I do not know why you are being charged extra for this 	A1YKWG46AWMPUX	
Do you sell floor mats 	I do not know if we sell floor mats 	A9LX66EQWDRQ5	
What are the benefits of learning Ballroom dancing 	I do not know the benefits of learning ballroom dancing 	A2NI2HSU84PHJW
I would like to buy a new laptop but it wo n't let me add it to my cart 	I am not able to help you add a new laptop to your cart 	A325WS381BHOHH	
I bought a couple of things right now , checked out , but realized I forgot a couple of things and am wondering if I can add them to my order 	I am not able to add the things that you forgot to your order 	AMELZJ4P3IIJH
What hours is your store open 	I am not able to tell you the hours our store is open 	A3RD486RQUI2XV
If , due to a disability , I am unable to travel to an IDNYC enrollment center , how can I apply for my IDNYC card 	I do not know how you would apply for an IDNYC card in case of a disability 	A16NITTBMCSN0V
What if I do not speak English 	I do not know if you do speak English 	A3722NOMVUK89T
I need to verify that you have my correct phone number 	I am not able to verify if we have the correct phone number 	A3VV5FFG6GXE1S	
Is photography permitted in the Anne Frank House 	I do not know if photography is permitted in the Anne Frank House 	A2HKTM4Z8652
I want to screen the film in my home . Do I still need to buy a license 	I do not know if you still need to buy a license to screen the film in your home 	A2VFX3J4B1I22X
What do I do if my package gets lost 	I do not know what you do if your package gets lost 	AE9M4Z1NCYSDM	
When must flexible retention periods be applied consistently across an agency or office 	I do not know when flexible rentention periods must be applied consistently 	A13GUTDMGGZZDL
When I am automatically upgraded , how do you assign my seat 	I do not know how we assign your seat when you are automatically upgraded 	AZLZA0Q87TJZO
Can you provide a breakdown of how many DACA EADs expire in 2017 , 2018 , and 2019 	I am not able to provide a breakdown 	A13GUTDMGGZZDL
Can I cancel or reschedule an appointment online 	I am not able to cancel or reschedule an appointment online 	A1S8DYWNS59XWB
When I called last time to ask about loan options , I spoke to someone really helpful . If I give you her name , is there a way you can connect me to her again 	I am not able to connect you to her 	391FPZIE4CEGVL3WC1QSE20V0WKUHL
Did John Wayne shoot any films in Lone Pine 	I do not know if John Wayne shot any films in Lone Pine 	A7SXWHGK8B40R
Can I purchase a Dorint voucher as a present 	I do not know if you can purchase a voucher as a present 	A13GUTDMGGZZDL
Why was my order canceled	I do not know why your order was canceled 	A18RMWE4BKHG6R
Is there anything I should n't bring 	I do not know if there is anything you should n't bring 	AZLZA0Q87TJZO
What does the Museum do to support teachers 	I do not know what the museum does to support teachers 	A1X3SF2W1QQBY1
when on a project assignment , who is my employer 	I do not know who your employer is when on a project assignment 	AHJYLSDFBLEWM
Is this a rain or shine event 	I do not know of the event 	A3722NOMVUK89T
Q : How long should I wait for the interview invitation after I summit my resume 	I do not know how long you should wait for the interview invitation after you summit your resume 	A1J0GU26323WVA
Can we bring our own picnic to the zoo 	I do not know if you can bring your picnic to the zoo	APF1EAZT104LQ
Is the boat handicap accessible 	I do not know if the boat is handicap accessible 	A3GNQDFPZALU92	
I think I need to cancel an order I just made 	I am not able to cancel your order 	AJKA9BKC011F2
Are my FMLA forms and informational posters out of date 	I do not know if your FMLA forms and informational posters are out of date 	A2HKTM4Z8652
Does the Library of Congress provide Z39 .50 access to authority records 	I do not know if the Library of Congress provides Z39 .50 access to authority records 	A1R1J3GL0YP7DJ
When is tuition do and how do I pay 	I do not know when tuition is do or how you pay 	A1R1J3GL0YP7DJ
Where can we find discount codes for the zoo 	I do not know where you can find discount codes for the zoo 	A2K9PB0U45O0MU
I had an unpleasant experience with a customer service agent , who can I talk to about this 	I do not know who you can talk to about this 	A1J0GU26323WVA
I forgot my answer to the challenge question , how do I access my account 	I do not know how you can access your account 	A2NI2HSU84PHJW
The price just came down 30 % on an item that I bought an hour ago , Can I get credited back some money 	I am not able to credit some money back to you 	A9LX66EQWDRQ5	
What are the premium rates 	I do not know what the premium rates are 	A1WRD2K9USCOAV
There 's no way I can make a payment tomorrow , can I have an easement until Friday 	I am not able to give you an easement until Friday 	39KV3A5D18Z3NJ5GAN9G8OTD1W3S71
Is govinfo 508 compliant 	I do not know if they are compliant 	A13GUTDMGGZZDL
What is the Intel ® Developer Zone 	I do not know what the Intel ® Developer Zone is 	A3RO0QIXW4IX3Y
What do I do if a class is full 	I do not know what you do if a class is full 	AFS36YMNN8A2J
What is my online account 	I do not know what your online account is 	A2D0IIX70FDQIW
Are the asphalt seeps restricted to the pits in Hancock Park 	I do not know if the asphalt seeps are restricted to the pits in Hancock Park 	A7SXWHGK8B40R
Does the Zoo have a reciprocal agreements with other institutions 	I do not know if the Zoo has reciprocal agreements with other institutions 	A2NI2HSU84PHJW
Do I need to file a claim with my insurance 	I do not know if you need to file a claim 	A325WS381BHOHH	
Can I pay with two different cards 	I do not know if you can pay with two different cards 	AE9M4Z1NCYSDM	
What expenses must be reimbursed 	I do not know what expenses must be reimbursed 	A16VTK6KZ1U69H
What are the museum 's admission fees to view the permanent collection 	I do not know what the museum 's admission fees are to view the permanent collection	ABWW1P7GZ4C0Z
How do I Book Group Reservations	I do not know how you book group reservations 	A3R71HP45TBQ7O
I ordered a package from the website , what is the estimated date of arrival and is there a tracking number for the shipment 	I am not able to track the estimated arrival date of your shipment 	3EFNPKWBMSGLLRKHZ9N6L1BE12Z03I
If I order 5000 of your units , can I get a bulk discount ? I am running a small business 	I am not able to give you a bulk discount 	36QZ6V158955LUHCNV2RIG7X971US6
When is my package going to arrive 	I do not know when your package is going to arrive 	A185P3B2MC2K83
I was n't sure about this bit of paperwork and could use some help 	I am not able to help you with this bit of paperwork 	AE9M4Z1NCYSDM	
What 's next for Congress.gov 	I do not know what is next for Congress.gov	APF1EAZT104LQ
What 's wrong with a jailbroken or rooted device 	I do not know what 's wrong with a jailbroken or rooted device	ATQD23E8ESFSI
Are there hands-on activities that the students can participate in when we visit 	I do not know if there are hands-on activities that the students can participate in when you visit	A23CTGXNDDW5LC
Do you offer an extended service plan 	I do not know if we offer an extended service plan 	A9LX66EQWDRQ5	
When should I submit my documents for the I-20 Certificate of Eligibility 	I do not know when you should submit your documents for the I-20 Certificate of Eligibility 	A1JBSFXMMRGSQD
Is the museum handicapped accessible 	I do not know if the museum is handicapped accessible	A23CTGXNDDW5LC
How do I know which level of class to take 	I do not know which level of class you should take 	A3P1SDBXCNU6C
If an HR manager makes a verbal promise to an employee that he or she would not be terminated , how does that affect the employment at-will status of that employee 	I do not know know how that affects the employee 's employment at-will status 	A13GUTDMGGZZDL
Which car park do you suggest for visitors to the Fashion Museum 	I do not know which car park I would suggest for visitors to the Fashion Museum 	A23RGQKZ0PPC46
What formats are available for community screenings 	I do not know the formats that are available for community screenings 	A2VIKCIM9TZL22
Is it possible to have a green smoothie delivered to my house every other morning 	I am not able to have a green smoothie delivered to your house every other morning 	3XABXM4AJ1XVAHVMSOCHROA7USOQ8X
I would like to know what happened to my order problem in the resolution center 	I do not know what happened to your order problem 	3GS542CVJVF6V0VYDOUST9ARI2K59P
Why ca n't I use the 20 % code Spring56 on my order 	I do not know why you ca n't use the 20 % code Spring56 on your order 	A31A4YKVSOYRVS	
Can we bring our pet 	I do not know if you can bring your pet 	A2115OWJ0CKOB3
Do you offer delivery of the pool table inside the house 	I do not know if we offer delivery of the pool table inside the house 	A3GNQDFPZALU92	
Do you have a mailing list I can sign up for 	I do not know if there is a mailing list 	A1HQRT1UG6ERGL
How can I be assured animals are treated humanely 	I do not know how you can be assured animals are treated humanely 	A2NI2HSU84PHJW
When will my shirt ship	I do not know when your shirt will ship 	A3GNQDFPZALU92	
Do I need a reason to dismiss on notice	I do not know if you need a reason to dismiss on notice 	AJ7E01X4TAGHL
When should a job offer be withdrawn 	I do not know when a job offer should be withdrawn 	A1S0R9UMW0FWAZ
My Cat Is Going Bald on Her Hind Legs . Should I Be Concerned 	I do not know if you should be concerned 	A7SXWHGK8B40R
Can I submit the paperwork online 	I do not know if you can submit the paperwork online 	A2YQAE441JMA7V	
How do I request a background check 	I do not know how you request a background check 	A3I9FTHSULHPYS
My product was delivered to my billing address instead of my shipping address 	I am not able to help you with your product that was delivered to your billing address instead of your shipping address 	A325WS381BHOHH	
How long will I be there 	I do not know how long you will be here 	A2K9PB0U45O0MU
What benefits am I entitled to at these museums 	I do not know what benefits you 're entitled to 	A13GUTDMGGZZDL
Am I allowed to bring my stroller or carrier into the theater 	I do not know if you can bring a stroller or carrier in the theater 	A2223XYV804AY7
Can I purchase Summer tickets in Winter , and vice versa 	I do not know if you can purchase Summer tickets in Winter , and vice versa 	A3RD486RQUI2XV
How do shellfish establish themselves on the sea bottom 	I do not know how shellfish establish themselves on the sea bottom 	A3G2FBKYCRD5Q8
I 'm filling out my address form , I have two different addresses , is there a place on the application to put in the other address 	I do not know where you can put the other address 	3UUSLRKAULVXLUMYDXERDP7D0TU7DN
How can I stop my free trial 	I do not know how you can stop your free trial 	A325WS381BHOHH	
Do you need a passport to cruise to Mexico 	I do not know if you need a passport to cruise to Mexico 	AD9O852KPYLHY	
How much dance training should a prospective student have prior to attending Point Park 	I do not know how much dance training a prospective student should have prior to attending Point Park 	A116N2LEI6O7HB
How long does it take for service to start 	I do not know how long it takes for service to start 	A3B1H161LQLAYP	
May we bring in decorations 	I do not know if you can bring in decorations 	APC99TPURUHR8
How do I set up mailing so your mail goes to my home address instead of my po box 	I do not know how you set up mailing so our mail goes to your home address instead of your po box	A23CTGXNDDW5LC	
What languages is the tour in 	I do not know what languages the tour is in 	A3RD486RQUI2XV
Does state tax treatment of cafeteria plan benefits match IRS rules 	I do not know if the state tax treatment of cafeteria plan benefits matches IRS rules 	A2K2MFQMN31DZ
Why am I not able to return these items 	I do not know why you are unable to return the items 	A3SZ3W7V3GUN8Z
My truck windshield is cracked , i wanted to know if the car insurance covers that 	I do not know if the car insurance covers that	375VSR8FVW1A6EB9ET1U9YHGPNXRZ4
I would like a paper invoice sent to me with the package 	I am not able to have a paper invoice sent to you with the package 	ASFR82SJYMGNU
If a zoo is part of a bigger attraction -LRB- eg a theme park -RRB- does the inspection take account of / inspect any of the non-zoo part of the attraction 	I do not know if the inspection takes account of/inspects any of the non-zoo part of the attraction if a zoo is part of a bigger attraction 	A2HKTM4Z8652
What time is it in Guatemala	I do not know what time is is in Guatemala 	A1J0GU26323WVA
What are we looking for as verification of registration with Selective Service 	I do not know what you are looking for as verification of registration with Selective Service 	A1J0GU26323WVA
What if I do n't have access to a printer or can not print the voucher 	I do not know what you should do if you do n't have access to a printer or can not print the voucher 	AFS36YMNN8A2J
I am interested in taking pictures at Philbrook , but the photographer is not professional . Do I still need to pay a fee 	I do not know if you will need to pay a fee 	A8O98QNRG9SHV
One of my team has announced she is pregnant , what do I need to do 	I do not know what you need to do 	A2NI2HSU84PHJW
I think I may have been charged twice , how do I fix this 	I do not know how you fix it 	A260AFDCSXBQOH
Will I need to provide my party 's guest and travel information during the purchase process	I do not know if you 'll need to provide this information 	A13GUTDMGGZZDL
I ca n't see my member discount in my shopping cart . What do I do 	I do not know what to do if you do n't see your member discount in your shopping cart 	APC99TPURUHR8
Do you charge a monthly fee for checking accounts 	I do not know if we charge a monthly fee for checking accounts	APF1EAZT104LQ
Collapse What should I do if my package is delayed or late 	I do not know what you should do if your package is delayed 	AOPI4DCPSO8H4
What events take place at the Museum and how do I book them 	I do not know what events take place at the Museum or how you book them 	A2HKTM4Z8652
Can I check my account balance 	I am not able to check your account balance	A31A4YKVSOYRVS	
I need to change my username and password 	I am not able to change your username and password 	A2PKDWREQV1JTR
What is Round Up for Conservation 	I do not know what Round Up for Conservation is 	A2NI2HSU84PHJW
Would I be able to reserve my order 	I am not able to reserve your order 	A9LX66EQWDRQ5	
Where is your studio , exactly 	I do not know where our studio is exactly 	A116N2LEI6O7HB
Do you know of any hotels near the Zoo 	I do not know of any hotels near the zoo 	A1J0GU26323WVA
What is the date and time of Brew at the Zoo 	I do not know what date and time 	AQ2U7QPE229VH
do you know when the next generation product will be available for this model , I am deciding if I should wait for the new line up or buy it now	I do not know when the next generation product will be available 	AMW07CJC3OJIB
When can I upgrade 	I do not know when you can upgrade 	AE9M4Z1NCYSDM	
What kinds of cases are heard in City Court of Slidell 	I do not know what kinds of cases are heard 	A325WS381BHOHH
Do you know how often one user buys this item ? What is the usual time frame that this product runs out 	I do not know how often one user buys this item or how often the product runs out 	372AGES0I4XL1JBUDBD9CD15HNZRX7
I forgot my password and need to make a new one	I am not able to help with your password and make a new one 	A2TKHXY755FAM
Does the museum have lockers , as well as a Cloakroom 	I do not know if the museum has lockers as well as a Cloakroom 	A3G2FBKYCRD5Q8
What does Nandi mean 	I do not know what Nandi means 	A9LX66EQWDRQ5
Are you able to give a refund if I do n't like the product 	I do not know if we are able to give a refund if you do n't like the product 	A31A4YKVSOYRVS	
How can I share my ideas for future exhibits 	I do not know how you could share your ideas for future exhibits 	A2VIKCIM9TZL22
I want to cancel my policy 	I am not able to cancel your policy	A23CTGXNDDW5LC
Where do I go to have my new motorcycle serviced ? I do not know how my policy works concerning that 	I do not know how your policy works or where you should go to have your motorcycle serviced 	3HEA4ZVWVDENUDTMAYHBHT5PW6155Y
Are there food and drinks provided for ArtScience Late 	I do not know if food and drinks are provided for ArtScience Late 	A1IPD4WBT3A5GG
Are there scholarships for dance here at LCC 	I do not know there are scholarships for dance here at LCC 	A2K9PB0U45O0MU
I need to speak with someone about my 401k portfolio . Would you be able to help me 	I am not able to help you speak with anyone about your 401K portfolio 	3IVKZBIBJ010G8BSNWVSZ1I7FZZSH3
How to buy	I do not know how to buy 	A3I9FTHSULHPYS
How long does it take for products to ship 	I do not know how long products take to ship 	AJNQ2PBD07FKE
How often does your company service their cars 	I do not know how often our company services our cars 	A9LX66EQWDRQ5	
Will this be reflected on my AT&T Mobility statement 	I do not know if this will be reflected on your AT&T Mobility statement 	A5VBIZ2KIQ1R8
I recently had a baby , got married/divorced , had a dependent graduate from college , or my spouse/partner 's benefits changed at his/her employer . How can I make the appropriate changes to my benefit selections 	I do not know how you can make the appropriate changes to your benefit selections 	A2K9PB0U45O0MU
How do I get an ID badge or door access to a research space 	I do not know how you get an ID badge or door access to a research space 	A16VTK6KZ1U69H
Where can I download a foot size template for ordering shoes from your website 	I do not know where you can download a foot size template for ordering shoes from our website 	AE9M4Z1NCYSDM	
Do you offer student discounts on your software 	I do not know if we offer student discounts on our software 	A3VV5FFG6GXE1S	
Will I be locked up in a hotel during the trial 	I do not know if you will be locked up in a hotel during the trial 	A7SXWHGK8B40R
I qualified for a position in the past , but now I do n't qualify . How can that be 	I do not know how you can qualify 	A1DWQO9X2ZQ35G
Which is the best tour 	I do not know what is the best tour 	A1S8DYWNS59XWB
Where can I check to see if my machine is under warranty 	I do not know where you can check to see if your machine is under warranty 	AISE949ZZN8HA
Does a consumer have to enter a username and password every time they wish to play a DRM protected video 	I do not know if a consumer has to enter a username and password every time they wish to play a DRM protected video 	A1JBSFXMMRGSQD
How long is kitchen craft 's Warranty	I do not know how long Kitchen Craft 's warranty lasts 	A1JBSFXMMRGSQD
What time do the lights come on 	I do not know what time the lights come on 	A2NI2HSU84PHJW
Are there nearby places for a quick lunch 	I do not know if there are nearby places for a quick lunch	A1GNG0J27JYSUB
My package was damaged , what is the process of seeing if my parcel was insured 	I do not know what the process is of seeing if your parcel was insured 	A9LX66EQWDRQ5	
Is there a way to check online whether an item is in stock in a store	I am not able to check online to see if an item is in stock in a store 	A3RD486RQUI2XV
I 'm not sure of the name of the ship my relative came here or served on -- can you help me 	I am not able to help you find out the name of the ship your relative came here or served on 	A16VTK6KZ1U69H
Why is my video lagging when I watch 	I do not know why your video is lagging when you watch it 	A31A4YKVSOYRVS	
Can you come on-site 	I am not able to come on-site 	A16VTK6KZ1U69H
How do I get to Bethel Woods	I do not know how to get bethel woods 	A2LQ9NP944M61Z
What is the incidental deposit policy 	I am not able to explain what the incidental deposit policy is 	A13GUTDMGGZZDL
If something breaks , where can I take it to get it fixed 	I do not know where you can take something to get fixed if it breaks 	AE9M4Z1NCYSDM	
Am I required to provide my employees benefits 	I do not know if you are required to provide your employees benefits 	A3E3J27LF4OX9M
What time was my item shipped today 	I do not know what time your item shipped today 	A31A4YKVSOYRVS	
Must I complete the form at the consulate or must it be completed before I go to the consulate 	I do not know if you must complete the form at the consulate or if it has to be completed before you go to the consulate 	A2K9PB0U45O0MU
Are there special limits in running credit checks on independent contractors 	I do not know if there are special limits 	A13GUTDMGGZZDL
Do I need to purchase an extended warranty 	I do not know if you need to purchase an extended warranty 	A13GUTDMGGZZDL
What is the average shipping time with your company 	I do not know what the average shipping time with your company is 	A31A4YKVSOYRVS	
Who can I contact if I have any questions or concerns about using my lawn pass	I do not know who you can contact if you have questions about using the lawn pass	APF1EAZT104LQ
Do only union employees have a right to engage in protected concerted activity over the internet 	I do not know if that pertains only to union employees 	A1I0AQEKVWIPXC
As an employer , am I liable for sexual harassment at my company , even if I do n't know about it 	I do not know if you are liable for sexual harassment at your company as an employer , even if you do n't know about it 	A3U0VQ420HIMQ0
Can you assist with filing my debt collection letter in preparation for my small claims court case on November 3rd 	I am not able to to assist you with filing 	3VQTAXTYN3D6480AC9GWSRXX5JFUB5
Why build a new courthouse 	I do not know why build a new courthouse 	A3I9FTHSULHPYS
If I delete my account is it really gone or do you save it somewhere 	I do not know if you delete your account if it is really gone or if we save it somewhere 	A325WS381BHOHH	
How long do I have to wait for the refund to show back up in my bank account 	I do not know how long you will have to wait for the refund to show back up in your account 	A31A4YKVSOYRVS	
Do international employees need to complete the Selective Service Eligibility and Verification Form 	I do not know if international employees need to complete the Selective Service Eligibility and Verification Form 	A2EJ7U3TZAKROG
Looking to become part of the Museums ' staff 	I do not know how to become part of the Museums ' staff 	A31JM9RECQGYEX
I ordered a custom product and am not sure if I can return it 	I do not know if you can return it 	AJ7MWBQFNH3E4
My cable service 's on demand function has not worked for three days due to internet connectivity , can a technician repair this for me 	I do not know if a technician can repair this for you	3G57RS03HHXVVGAZSFFDJM2DCWA52X
How much time should be allocated for a school / group visit to the zoo 	I do not know how much time to allocate for a school/group visit to the zoo 	A1BYVSM1G333O4
Can I receive academic credit for my participation in the Internship Program 	I do not know if you can receive academic credit for your participation in the Internship Program 	A2K2MFQMN31DZ
Where should I purchase dance attire and shoes 	I do not know wher eyou should purchase dance attire and shoes 	A13GUTDMGGZZDL
Is there maternity/paternity leave 	I do not know if there is maternity/paternity leave 	AF1VPADWTM40W
Do you offer any financing 	I am not able to offer any financing 	A3B2YRXL26RPVH
What carrier do you use to ship items 	I do not know what carrier we use to ship items 	A9LX66EQWDRQ5	
Can you verify the address this order is being shipped to 	I am not able to verify the address that this order is being shipped to 	A9LX66EQWDRQ5	
My airline ticket was lost over the weekend can i get reimburse back my money 	I do not know if you can get reimbursed 	3WYZV0QBFJ5YLCU5HERJCYW1Z1WXB0
May an employer terminate an employee who exhausts Family and Medical Leave Act -LRB- FMLA -RRB- leave and does not return to work 	I do not know if an employer can terminate an employee who exhausts Family and Medical Leave Act -LRB- FMLA -RRB- leave and does not return to work 	APC99TPURUHR8
what are the hours of your store 	I do not know the hours of our store 	A1YKWG46AWMPUX	
What constitutes a ' public ' screening 	I do not know what constitutes a public screening 	A13GUTDMGGZZDL
Can I pay by check 	I do not know if you can pay by check 	A31A4YKVSOYRVS	
Can you help me track down my lost luggage 	I am not able to help you track down your lost luggage 	A31A4YKVSOYRVS	
Last year , my parents and I both took out student loans for me . We both received Form 1098-E for our separate loans . I was n't their dependent last year . Can we both claim student loan interest on our tax returns 	I do not know if you can both claim student loan interest on your tax returns 	ARKAJ6PL85CME
Will my insurance rates go up if I get into an accident 	I do not know if your insurance rates will go up if you get into an accident 	A2IXBTOWQRCLPZ	
How do I rent your facility for a birthday party 	I do not know how you rent our facility for a birthday party 	A1YKWG46AWMPUX	
How can I help 	I do not know how you can help 	A27MJOV91GA8R3
What shipping carier do you use 	I do not know what shipping carier we use 	AD9O852KPYLHY	
What is the APR on your financial option 	I do not know what the APR on our financial option is 	A31A4YKVSOYRVS	
Where is the gift shop 	I do not know where the gift shop is 	A1XNCA1SVTT15B
Why did they not include the AVP series in this movie 	I do not know why they did n't include the AVP series in this movie 	A1AVKKVWWFUGLT
Are there any positions available at the Museum 	I do not know if there are any positions available at the museum 	A13GUTDMGGZZDL
Would it be possible to ship my monthly subscribe and save order 1 week early 	I am not able to ship your monthly subscription one week early 	A3RD486RQUI2XV
Do you sell ypur online products in-store 	I do not know if we sell our online products in-store	AYJGJAIY0EXW
Does your store price match branded bags with online price if I have to stop by and purchase an item 	I do not know if the store price match branded bags with online price 	3YLPJ8OXX85E0D9W2ZHW4KQVP9FX4U
Do you do tours 	I am not able to do tours	A23CTGXNDDW5LC
Do you have educational programs 	I do not know if we have education programs 	A13GUTDMGGZZDL
How do I know which product is right for me 	I do not know which product is right for you 	A325WS381BHOHH
When is this newest product going to be available 	I do not know when the newest product is going to be available 	A1J0GU26323WVA
I 'm trying to find a place that will board pets for 2-3 nights on short notice . Does your place do anything like that 	I do not know if our place will board pets for 2-3 nights on short notice 	3EN4YVUOUCK43VSH5640AMFE765XJL
Should I call ahead before coming in for research 	I do not know if you should call ahead before coming in for research 	A1JBSFXMMRGSQD
What is your daily admission fee 	I do not know what our daily admission fee is 	A3U0VQ420HIMQ0
Are international transit times always met 	I am not able to tell you if international tansit times are always met 	A116N2LEI6O7HB
Can you reserve the Museum for events 	I am not able to reserve the Museum for events	A23CTGXNDDW5LC
How do I terminate my software license contract 	I am not able to terminate your software license contract 	A1BWNS27NA1JAP
I need to change the date of my monthly payment from the 1st to the 15th of each month 	I am not able to change the date of your monthly payment from the 1st to the 15th of each month 	A3GNQDFPZALU92	
How do I make a correction to my online order 	I do not know how you would make a correction to your online order 	A3RO0QIXW4IX3Y
What name should I enter in my account 	I do not know what name you should enter in your account 	A116N2LEI6O7HB
Are there any deferment options for my next payment 	I do not know if there are deferment options for your next payment 	A260AFDCSXBQOH
What is the difference between a tourist visa and a business visa 	I do not know what the difference is between a tourist visa and a business visa 	A16VTK6KZ1U69H
My tracking shows that item is delivered but I have n't received it yet , could you please check it	I am not able to check it even though your tracking shows that item is delivered but you have n't received it yet 	3SZYX62S5GS2HH75YRW8FDJLNCW75F
How can I change my appointment to a later time on September 4th ? I have another appointment and need to reschedule please 	I do not know how you can change your appointment to a later time on September 4th	32PT7WK7DM7FKBLBBLB108VXVR83DE
If I buy a flight ticket with ANA SKY COIN , do I have to use the flight ticket within the ANA SKY COIN period of validity 	I do not know if you have to use the flight ticket within the ANA SKY COIN period of validity 	A2K9PB0U45O0MU
What is one serving 	I do not know what one serving is 	A2NI2HSU84PHJW
What flavors do you offer of this item 	I do not know what flavors we offer for this item 	A31A4YKVSOYRVS	
Will my product be repaired or replaced under warranty 	I do not know if your product will be repaired or replaced under warranty 	AJ7MWBQFNH3E4
WHAT ARE THE STADIUM TOURS & MUSEUM OPENING HOURS	I do not know what the opening hours are 	A3722NOMVUK89T
There 's been a lot of flooding in my area ; is this going to affect how long it takes my item to arrive 	I do not know how long it will take your item to arrive 	AD9O852KPYLHY	
My spouse and I are filing as married filing separately . We both contributed to the support of our son . Can we both claim a dependency exemption for him on our separate returns 	I do not know if you and your spouse can both claim your son as a dependency exemption if you file separate returns , since you both contributed to his support 	A1JBSFXMMRGSQD
How can I find out the status of my order 	I do not know how to find the status of your order 	AJKA9BKC011F2
I 'm unable to find an old order on my history 	I am not able to find your old order history 	AJNQ2PBD07FKE
Can I view the security questions that I set up 	I do not know if you can view the security questions 	A2NI2HSU84PHJW
Can I change the day on my flight from New York to Vancouver from Wednesday to friday 	I do not know if you can change the day of your flight 	3XBXDSS888BAYLGH8RGDQ1S6BVAXLN
I just received my new phone . How do I port my number from my old carrier to this service 	I do not know how to port your number 	3E9ZFLPWOYK88K8BNOJ0YL0EURGXI9
Do I receive a discount on admission tickets purchased for guests 	I do not know if you receive a discount on admission tickets purchased for guests 	A1S8DYWNS59XWB
Once I enter the venue , can I leave and return	I do not know if you can leave and return once you enter the venue 	A3G2FBKYCRD5Q8
How do I report equipment that is returned to IBM or sold to another business 	I do not know how you can report equipment that is returned to IBM or sold to another business 	A2K9PB0U45O0MU
Can I apply in person , using a paper application 	I do not know if you can apply in person , using a paper application 	A3SS1F4F3JE7CU
Can I have the delivery date for this package sent to me at an earlier time instead of later 	I do not know if the delivery date can be sent to you earlier	3I7SHAD35MO0POSBQQDUWFU797M7M5
Do you need the last 4 digits of my social 	I do not know if you need the last 4 digits of your social 	ASFR82SJYMGNU
Will my membership card be mailed to me 	I do not know if the membership will be mailed to you 	A2NI2HSU84PHJW
When does a private lesson package expire	I do not know when a private lesson package expires 	A7SXWHGK8B40R
Is an employer required to shred paperwork that contains personal information 	I do not know if an employer is required to shred paperwork that contains personal information 	A2I4VNAS21FXCE
I placed an order so why have I not received a confirmation email	I do not know why you have not received a confirmation email 	A1HQRT1UG6ERGL
Are there optional upgrades to the standard Powertrain Coverage 	I do not know if there are optional upgrades to the standard Powertrain Coverage 	A2NI2HSU84PHJW
Where can I get information on volunteering at the Museum 	I do not know where you could find information on volunteering at the museum 	A3AI03PYJ47OVC
Is there a chance I can pay once for a yearly subscription instead of monthly 	I do not know if you can pay once for a yearly subscription instead of monthly 	A3RD486RQUI2XV
Where can I find 2018 plans and prices 	I do not know where you can find 2018 plans and prices 	A9LX66EQWDRQ5
Must I serve if I am not a United States citizen 	I do not know if you must serve if you are not a United States citizen 	A2NI2HSU84PHJW
If a taxpayer adopts the child of his or her registered domestic partner as a second parent or co-parent , may the taxpayer -LRB- ' adopting parent ' -RRB- claim the adoption credit for the qualifying adoption expenses he or she pays to adopt the child 	I do not know if the taxpayer can claim the adoption credit for the qualifying adoption expenses 	A2K9PB0U45O0MU
What kinds of alcohol are available in Guatemala	I do not know what kinds of alcohol are available in Guatemala 	A2K9PB0U45O0MU
Do you plan to produce an online format 	I do not know if I plan to produce an online format 	A1JBSFXMMRGSQD
Are service dogs allowed at the zoo 	I do not know if service dogs are allowed at the zoo	A23CTGXNDDW5LC
Would it be faster if I picked up the order instead 	I do not know if it would be faster if you picked up the order instead 	A3VV5FFG6GXE1S	
I placed an order yesterday , can you tell me what account that is on 	I am not able to tell you what account that is on	3QI9WAYOGQ3KJJRBRD4O2ATH6LJS62
Is it possible to change the shipping address on something I ordered yesterday 	I do not know if it is possible to change the shipping address 	AD9O852KPYLHY	
What can be done for an employee whose court-ordered garnishments are an excessive burden 	I do not know what can be done for an employee whose court-ordered garnishments are an excessive burden 	A3THR2UWGQNVX4
What methods of payment can I use online 	I do not know what methods of payments you can use online 	A8O98QNRG9SHV
How does KAM manage image rights and permissions for art in the permanent collection 	I do not know how KAM manages image rights and permissions for art in the permanent collection 	A1JBSFXMMRGSQD
Why is n't my photo showing in Self Service 	I do not know why your photo is n't showing in self service 	A3RD486RQUI2XV
May an employer charge more for the same benefit provided to different employees 	I do not know if an employer may charge more for the same benefit provided to different employees 	A1S0R9UMW0FWAZ
Ca n't find what you are looking for 	I do not know why you ca n't find what you are looking for 	A7SXWHGK8B40R
How much will it cost to repair my phone screen 	I do not know how much it will cost to repair your phone screen 	A3VV5FFG6GXE1S	
Is there any way my rate can be lowered 	I am not able to tell you if there is any way your rate can be lowered 	A3G2FBKYCRD5Q8	
Is the Museum usually crowded with school groups 	I do not know if the Museum is usually crowded with school groups 	A3UUH3632AI3ZX
Can I pay with PayPal on an order 	I do not know if you can pay for an order with PayPal 	A9LX66EQWDRQ5	
Do nonexempt employees have to be paid for their commutes if they are using a company car 	I do not know if nonexempt employees have to be paid for their commutes if they are using a company car 	A3SS1F4F3JE7CU
Is there an indoor place where I can breastfeed my baby 	I do not know if there is an indoor place where you can breastfeed your baby 	A1JBSFXMMRGSQD
Tell me how to change the mailing address for my account , it just wo n't let me update anything	I am not able to tell you how to change the mailing address for your account	3JUDR1D0D6JKO2TXC73GHXX48SX2Q7
Is the price of shipping included in the kit price 	I do not know if the price of shipping is included in the kit price 	AD9O852KPYLHY	
If tickets for the event are listed as sold-out online , does that mean I ca n't come 	I do not know if you ca n't come if tickets for the event are listed as sold-out online 	AZLZA0Q87TJZO
If my child is sick or misses class for any other reason , can she/he make it up 	I do not know if your child is sick or misses class for any other reason , if she/he make it up 	A3RD486RQUI2XV
I wanted to check on my airline reservation . Are their any aisle seats available on my outbound flight 	I am not able to tell you if there are aisle seats available 	389A2A304OA9YRG0S2Y7E4F87FC0CG
Does this program apply to me if I am not receiving home and community based waiver services or nursing home services 	I do not know if the program applies to you if you are not receiving home and community based waiver services or nursing home services 	A3CL6GEDFNQGQY
How does one modify the contents of an order ? There 's a few things I no longer need in this package	I do not know how you modify the contents of the order 	382GHPVPHSJ2KF2IIAA8X41RIEF341
What age are the dancers 	I do not know what age the dancers are 	A1J0GU26323WVA
When is my best chance for getting through if I 'm trying to talk to a manager ? I 've been calling every day for the last week 	I do not know when your best chance of getting through to talk to a manager will be 	3EN4YVUOUCK43VSH5640AMFE765XJL
Can I get my invoice emailed to me from now on 	I do not know if you can get your invoice emailed from now on 	A2PKDWREQV1JTR
How much does TurboTax Online cost 	I do not know how much TurboTax Online costs 	AFS36YMNN8A2J
The dress I ordered arrived with a tear in it ; can I get some kind of discount 	I am not able to give you a discount 	A113OGTB578EF6	
Is my membership at Science Museum Oklahoma valid at other Oklahoma museums 	I do not know if the Science Museum Oklahoma membership is valid at other Oklahoma museums 	A234VIHHUHPZG5
Is it possible to book a traveling zoo program for a birthday 	I do not know if it is possible to book a traveling zoo program for a birthday	A23CTGXNDDW5LC
Can I cancel an order mid-shipment 	I am not able to cancel an order mid-shipment	APF1EAZT104LQ
how can I track my package once it 's been shipped	I do not know how to track your package once shipped 	AJ7MWBQFNH3E4
What is the procedure to follow to obtain authorization to shoot 	I do not know what the procedure is to obtain authorization to shoot 	A16NITTBMCSN0V
What do I do if I 'm having chest pains 	I do not know what you should do if you are having chest pains 	A9LX66EQWDRQ5
What is a manufacturer 's warranty 	I do not know what a manufacturer 's warranty is 	AZLZA0Q87TJZO
Can I add foster children to our membership	I do not know if you can add foster children	AXY0D2AMLKE2A
Is the house air conditioned 	I do not know if the house is air conditioned 	A116N2LEI6O7HB
Do you have anybody here who can help me with decorating designs for my home 	I do not know if we have anybody here who can help you with decorating designs for your home 	A325WS381BHOHH	
Can I get technical assistance on the parts 	I am not able to provide technical assistance on the parts 	A1J0GU26323WVA
I exercised my rights to receive life insurance distributions before death . Are these proceeds taxable 	I do not know if life insurance distributions before death are taxable 	A2K9PB0U45O0MU
What is a ' Course ' 	I do not know what a Course is 	A18KR781AUQBA6
How can I change the shipping address on an order I placed that 's already marked as shipped 	I do not know how you can change the shipping address on an order you placed that 's already marked as shipped 	30U1YOGZGAOJ4S6Q10C28G39N76SDU
What does the scholarship cover 	I do not know what the scholarship covers 	A3MFFF0TPDZQZS
My new microwave was just delivered but it 's broken 	I am not able to hlep you with your new microwave that was just delivered but is broken 	A325WS381BHOHH	
Can I register several sensors on one account 	I do not know if you can register several sensors on one account 	A2HKTM4Z8652
What day should I expect my package to arrive at my doorstep 	I do not know what day you should expect the package to arrive at your doorstep 	A31A4YKVSOYRVS	
Do you offer a store credit card 	I am not able to offer a store credit card 	AE9M4Z1NCYSDM	
what is the true description of a sardine 	I do not know what is the true description of a sardine 	A116N2LEI6O7HB
What should I know before I arrive 	I do not know what you should know before you arrive 	A2NI2HSU84PHJW
How am I charged for The Verizon Plan 	I do not know how you are charged for The Verizon Plan 	A30YFEIPGXNWJL
How do I set up a subscription 	I do not know how to set up a subscription 	A185P3B2MC2K83
What is your most popular add on item that people buy 	I do not know what the most popular add on item is that people buy 	AE9M4Z1NCYSDM	
Do you have an address where I can return clothe ? I lost the packing slip , is that OK just to print out order confirmation email 	I do not know if there is an address where you can return clothing 	3GVPRXWRPHMET52K5BF24MNQSY27IP
If we get disconnected , can you call me back on my cell phone or do I have to call you back 	I do not know if I can call you back on your cell phone 	3YO4AH2FPDCDSSQJXKZ2Y94PBUCQ0A
Which countries take part in the Schengen Agreement 	I do not know which countries take part in the Schengen Agreement 	A2HKTM4Z8652
I have a paper due next week and would like to get some information on the waterways in PA , could you let me know where on your website I can find this 	I am not able to let you know where on our website you can find this	3SBX2M1TKDFURG8KGLM4ACU2S6SQ4Q
Does your salon work with kids 	I do not know if our salon works with kids 	AE9M4Z1NCYSDM	
How long is your current advertisement good for 	I do not know how long our current advertisement is good for 	A325WS381BHOHH	
I have an order in transit to my home that I 'd like to cancel . What is your policy on cancellations 	I do not know our policy on cancellations 	3W31J70BASOBBHN4WV8PXOUHLDICKY
How long can I stay in Guatemala	I do not know how long you can stay 	A13GUTDMGGZZDL
How may I change my mailing address , email address or any other personal information 	I do not know how you can change your mailing address , email address , or any other personal information 	A2K2MFQMN31DZ
How can I stay in contact with the Museum 	I do not know how you can stay in contact with the Museum 	AZLZA0Q87TJZO
If I win my case , what am I entitled to 	I do not know what you are entitled to 	A7SXWHGK8B40R
I understand that networking is important at work , but I am fairly introverted . Any ideas 	I do not know if we have any ideas 	A7SXWHGK8B40R
where can I find your privacy policy 	I am not able to tell you where to find our privacy policy 	AE9M4Z1NCYSDM	
How to delete/unbound Nut 	I do not know how to delete/unbound Nut 	A2LQ9NP944M61Z
I 've heard that I need a waiting number to get into the Chichu Art Museum and the Minamidera -LRB- Art House Project -RRB- when they are crowded 	I do not know when they are crowded 	A2NI2HSU84PHJW
Can you tell me if the shirt I ordered can be switched to a different size 	I am not able to switch your shirt to a different size	3S37Y8CWI8SZBD46SULA21COG7A4W9
I need an update on my order 	I am not able to give you an update on your order	AYJGJAIY0EXW
Can I lose weight with this product 	I do not know if you can lose weight with this product	A23CTGXNDDW5LC
Are your aircraft flight worthy 	I do not know if our aircraft are flight worthy 	A3G2FBKYCRD5Q8
When is my $ 100 non-refundable Deposit Due 	I do not know if your $ 100 non-refundable deposit is due 	A298FAWY76NZA9
How much do the dances cost and can anyone come 	I do not know how much the dances cost and I do not know if anyone can come 	ARKAJ6PL85CME
How much does it cost to visit the Tombstone Epitaph Museum 	I do not know how much it costs to visit the Tombstone Epitaph Museum 	A13GUTDMGGZZDL
Can you match a price I just found somewhere else 	I do not know if we can match a price 	AD9O852KPYLHY	
What happens after the free trial 	I do not know what happens after the free trial 	A3U0VQ420HIMQ0
Order me khaki pants	I am not able to order you khaki pants	A23CTGXNDDW5LC	
What type of camera does your new phone have 	I do not know what type of camera the new phone has	AJ7MWBQFNH3E4
Does SMoCA have a rental program 	I do not know if SMoCA has a rental program 	A2K9PB0U45O0MU
How do I cancel this service 	I do not know how you cancel this service	A23CTGXNDDW5LC
How many people visit the national parks 	I do not know how many people visit the national parks 	A3I9FTHSULHPYS
Is there a parent drop off area 	I do not know if there is a parent drop off area 	A1JBSFXMMRGSQD
Can I take photos during my visit 	I do not know if photos can be taken 	A2O2Q0LVWOWJ1G
How much does it cost to join 	I do not know how much it costs to join 	A2NI2HSU84PHJW
Does the Federal Reserve tell the public what it holds on its balance sheet 	I do not know what the Federal Reserve tells the public it holds on its balance sheet 	A2NI2HSU84PHJW
I get your paper daily , but will be going on vacation at the end of this month . Can I get credited and stop delivery so I do n't have papers in front of my house while I 'm away 	I do not know if you can stop delivery 	3R0WOCG21M1ZJ5YUQ572NHLX84RUDC
Before Camp : What should my camper bring to camp 	I do not know what your camper should bring to camp 	AZLZA0Q87TJZO
Can I retrieve my messages for a different telephone number without having to hang up and redial into the voicemail system 	I do not know how you can retrieve your messages for a different telephone number without having to hang up and redial into the voicemail system 	A7SXWHGK8B40R
Who is the administrative contact , and who is the technical contact 	I do not know the administrative contact IS OR who is the technical contact	ATQD23E8ESFSI
How are Travel Advice and Advisories developed and maintained 	I do not know how Travel Advice and Advisories are developed and maintained 	A1X3SF2W1QQBY1
I Am Disabled ; will I be able to go on a stadium tour at Emirates Stadium	I do not know if you will be able to go on a stadium tour at emirates stadium	A23CTGXNDDW5LC
Can I book a one-way car rental 	I am not able to book a one-way car rental 	ARKAJ6PL85CME
I have n't received my package yet , could you check on it for me 	I am not able to check on your package 	A1J17BE20G6DKA
Once I am issued a visa , can I travel all over Russia 	I do not know if you can travel all over Russia 	A13GUTDMGGZZDL
I wanted to change my health plan , so can i do that online or do i need to talk to an agent 	I do not know if you can do that online nor if you need to talk to an agent 	3HEADTGN2PKTXU6ZDWCROS4K1CRRV4
I am an Irish national . My spouse / civil partner is a visa required national . Do they need a visa to visit/live in Ireland 	I do not know if your spouse / civil partner needs a visa to visit/live in Ireland	ABWW1P7GZ4C0Z
I was at one of your locations and fell due to a spill on your floor . Who do I need to talk to about filing an incident report 	I do not know who you need to talk to about filing an incident report 	3Y7LTZE0YTE2M63QINWZE940WM1ZUG
May I make an employment offer contingent upon successfully passing a physical 	I do not know if you can make an employment offer contingent upon successfully passing a physical 	A13GUTDMGGZZDL
Can I see my vacation and sick accrual balance 	I am not able to show you your vacation and sick accrual balance 	AT7ADQKXKXEWY
Can I switch to another carrier without paying an Early Termination Fee before my service transitions to AT&T 	I do not know if you can switch to another carrier without paying an Early Termination Fee before your service transitions to AT&T 	A7SXWHGK8B40R
Is the seafood quality	I do not know if the seafood is quality 	A8F4B0854KTXO	
There are purchases I did n't make on my statement , can I speak to someone about it 	I am not able to address purchases that were n't made and are on a your statement 	AJQGWGESKQT4Y
Is there an account manager I can speak to 	I do not know if there is an account manager you can speak to 	ASFR82SJYMGNU
Where do I submit my student organization 	I do not know where to submit your student registration 	A20WRVVT7WQFT7
I forgot to clock in/out how do I fix my time 	I do not know how you can fix your time 	A16NITTBMCSN0V
Is there a website that can show me everything in box office history 	I do not know if there is a website that can show your box office history 	A2NI2HSU84PHJW
What can I do to have my package sent to another location aside from the one on my order 	I do not know what you can do to have your package sent to another location aside from the one on your order	3T8DUCXY0NY8G26OEKCQWPG5Y569TK
Can I have a device payment agreement without an active Verizon Wireless mobile number 	I am not able to tell you if you can have a device payment agreement without an active Verizon Wireless mobile number 	A2UBEPT605E8T2
Will my insurance company pay for a rental if I was in a wreck 	I do not know if your insurance company will pay for a rental if you were in a wreck 	A3SSJNH5SIZUPG	
How is check - in or registration handled for the competition 	I do not know how check-in or registration is handled for the competition 	A10249252O9I20MRSOBVF
I was wondering if there were any promotional specials going on 	I do not know if there are any promotional specials going on 	A31A4YKVSOYRVS	
What types of photography or videography are allowed in the Museum 	I do not know what types of photography or videography that are allowed in the Museum 	A1R1J3GL0YP7DJ
Which Airlines fly to Panama from which US and Europe and from which cities 	I do not know which airlines fly to Panama from US and Europe , or which cities 	A1X3SF2W1QQBY1
Can I get a confirmation number 	I am not able to give you a confirmation number 	AD9O852KPYLHY	
Does your company have any plans to open up any more of your burger restaurants in other areas 	I do not know if our company has any plans to open any more of our burger restaurants in other areas	39TX062QX1GTIHQS2LCDUFYPB9JX39
Can I leave the museum and come today	I do not know if you can leave the museum and come today	A23CTGXNDDW5LC
Do you have to be a certain age to attend 	I do not know if you need to be a certain age to attend	APF1EAZT104LQ
Do members receive a discount at the gift shops 	I do not know if members receive a discount at the gift shops 	APC99TPURUHR8
The other day I noticed that your restaurants hours had gotten shorter , can you explain why 	I do not know why our restaurants hours got shorter 	39XCQ6V3KYWJDHT0FHRG9ZJPS1C56E
How many animals does the Zoo have 	I do not know how many animals the zoo has 	A16VTK6KZ1U69H
What type of organization is the Museum 	I do not know what type of organization the Museum is 	A1JBSFXMMRGSQD
Can the Gallery appraise my artwork or artifacts 	I do not know if the Gallery can appraise your artwork or artifcats 	A2NI2HSU84PHJW
How come the monthly fee is going up 	I do not know why the monthly fee is going up 	A260AFDCSXBQOH
How much does parking cost and where do I pay 	I do not know how much parking costs , or where you pay 	AT7ADQKXKXEWY
Does this shirt come in children 's sizes 	I do not know if this shirt comes in children 's sizes 	A31A4YKVSOYRVS	
How should an employer handle a bomb threat 	I am not able to tell you how an employer should handle a bomb threat 	A18RMWE4BKHG6R
Do you insure your products when you ship them 	I do not know if products are insured when shipped 	AJNQ2PBD07FKE
How many people live in Corning 	I do not know how many people live in Corning 	A3I9FTHSULHPYS
How can I track my order 	I do not know how you can track your order 	A1JBSFXMMRGSQD
Do you have anything on discount 	I do not know if we have anything on discount 	A260AFDCSXBQOH
Does your store carry heirloom seeds 	I do not know if our store carries heirloom seeds 	AE9M4Z1NCYSDM	
Could you assist me with my luggage 	I am not able to assist you with your luggage 	A9LX66EQWDRQ5	
What are Blue Credits 	I do not know what Blue Credits are 	A16VTK6KZ1U69H
I am not receiving membership emails . How do I SIGN UP TO RECEIVE THEM	I do not know how do you sign up to receive membership emails 	A3SS1F4F3JE7CU
What are my options , now that my car lease is almost up 	I do not know what your options are , now that yor car lease is almost up	A23CTGXNDDW5LC	
When does the Dance Department hold scholarship auditions 	I do not know when the Dance Department holds scholarship auditions 	A2HKTM4Z8652
I need to change my phone number	I do not know how to change your phone number 	A1GAARR4GOOZCO	
How does E-TRAC handle multiple approver at the same level 	I do not know how the E-TRAC handles multiple approver at the same level 	A3CL6GEDFNQGQY
How do I return a school book rental once the semester is over 	I do not know how you return a school book rental once the semester is over	A23CTGXNDDW5LC	
What is included in the admission price 	I do not know what is included in the admission price 	A3U0VQ420HIMQ0
Are there tours for people with visual impairments 	I do not know if there are tours for people with visual impairments 	A11IEP7J8XSE1C
What happens if my card is lost or stolen 	I do not know what happens if your card is lost or stolen 	A3CL6GEDFNQGQY
Where can I find primary sources about the transcontinental railroad 	I do not know where you can find primary sources about the transcontinental railroad 	A2NI2HSU84PHJW
How is a side pot is shared 	I do not know how a side pot is shared 	A9LX66EQWDRQ5
Can I ask how much are tickets going to be next month , to San Francisco by plane 	I do not know how much the tickets are going to be next month for a flight to San Francisco 	33NKDW9FFXAHVHMBVENENI2JHMWXC7
If it says zero in stock , is that really true 	I do not know how many are in stock 	AD9O852KPYLHY	
Why do you need to see my ID to notarize this document 	I do not know why we need to see your ID to notarize this document 	A325WS381BHOHH	
Can I copyright the name of my band 	I do not know if you can copyright the name of your band 	A2K9PB0U45O0MU
Once an individual 's DACA expires , will their case be referred to ICE for enforcement purposes 	I do not know if their case will be referred to ICE for enforcement purposes 	A13GUTDMGGZZDL
What coverage would you recommend for me 	I am not able to recommend coverage for you 	AE9M4Z1NCYSDM	
What is the duration for ArtScience Late 	I do not know the duration of ArtScience Late 	A8O98QNRG9SHV
I ordered my laptop computer cooler over two weeks ago . How long will it be until I get my order 	I do not know how long it will take to get your order 	3Z8UJEJOCZ53HL8UZ56ZECC746T39X
Are the Reserve Banks ' boards of directors involved in banking supervision matters 	I do not know if the Reserve Banks ' board of directors is involved in banking supervision matters 	A3U0VQ420HIMQ0
Do you have any new products 	I do not know if we have any new products 	A3SSJNH5SIZUPG	
I need to change the details for my credit card info 	I am not able to change the details of your credit card info 	AJKA9BKC011F2
Can you tell me why me subscription has not arrived	I am not able to tell you why your subscription has not arrived	A23CTGXNDDW5LC
Are pets allowed at the Air Museum 	I do not know if pets are allowed at the Air Museum 	A14M2EERU7E8KD
What documents should I receive from my employer 	I do not know what documents you should receive rom your employer 	AU3WB2DD4QJ4B
Does my company provide a discount on this service 	I do not know if your company provides a discount on this service 	A325WS381BHOHH	
I was supposed to be picking up an online order , but I need to send someone else to pick it up - how do I do that 	I do not know how you do that	3NZ1E5QA6ZTPJTAVB88OKF5H62N5BZ
How far back may an employer search into a job applicant 's past for criminal convictions 	I do not know how far back an employer can search into a job applicant 's past for criminal convictions 	A1J0GU26323WVA
Do you have a petting zoo 	I do not know if we have a petting zoo 	A9LX66EQWDRQ5
When purchasing flight tickets with ANA SKY COIN , how do I pay the remaining balance 	I do not know how you pay the remaining balance when purchasing flight tickets with ANA SKY COIN 	AZLZA0Q87TJZO
How do I renew my membership online 	I do not know how you renew your membership online	A23CTGXNDDW5LC
How can I purchase or renew a membership 	I do not know about the membership 	A3722NOMVUK89T
Is there a limit to the amount of calls I can make with Robo-Dialer 	I do not know if there is a limit to the amount of calls you can make with Robo-Dialer 	A2LQ9NP944M61Z
Can I use a gift card to purchase a membership	I do not know if you can use a gift card to purchase a membership 	A3SS1F4F3JE7CU
Do you offer Kosher catering 	I do not know if we offer Kosher catering 	A31A4YKVSOYRVS	
How do we take MAX to the zoo 	I do not know how you take MAX to the zoo 	A1J0GU26323WVA
What 's The Verizon Plan , and can I still sign up for it 	I do not know what the Verizon plan is or if you can still sign up for it 	A3RD486RQUI2XV
What is the address for your corporate headquarters ? I 'd like to mail a letter to your president 	I do not know the address 	3UAU495MIIKQN2PJGELIYBXWCIYUO9
I keep receiving emails from your company , can you remove me from the mailing list 	I am not able to remove you from the mailing list 	AQGBE43JMWHSR
Are video files ever left unencrypted on consumer 's storage 	I do not know if video files are ever left unencrypted on consumer 's storage 	A2NI2HSU84PHJW
Can an employer terminate an employee who is out on FMLA leave 	I do not know if an employer terminate an employee who is out on FMLA leave 	A325WS381BHOHH
Can we buy an annual pass to the zoo 	I do not know if you can buy an annual pass to the zoo	A23CTGXNDDW5LC
I 'm trying to create a landing page for my business on your website . Is there a way for me to see my page as a customer 	I do not know if there is a way for you to see your page as a customer 	3QXFBUZ4ZK82VP8LSV8AT2OULW7UGM
I only buy products made in the United States . Can you tell me where your products are manufactured 	I do not know where the products are manufactured 	31KSVEGZ34K6CJ6436HNAUNY8LTRWE
Does Dance Studio No. 1 have a dress code 	I do not know if Dance Studio No. 1 has a dress code 	A2NI2HSU84PHJW
How far is the Zoo from Colwyn Bay Town Centre 	I do not know how far the Zoo is from Colwyn Bay Town Centre 	A10249252O9I20MRSOBVF
Who do I contact to change the address on my invoice 	I do not know who you contact to change the address on your invoice 	A7SXWHGK8B40R
Does your company have a direct contact for the courier 	I do not know if our company has a direct contact for the courier 	A9LX66EQWDRQ5	
How is an offer of COBRA continuation coverage reported under Sections 6055 and 6056 	I do not know how an offer of COBRA continuation coverage is reported under sections 6055 and 6056 	A2TP3K1THK6XRB
What support do you offer for students with a disability or dyslexia 	I do not know what support we offer for students with a disability or dyslexia	A23CTGXNDDW5LC
I would like to change my address . Can you do that for me 	I am not able to change your address	A3VV5FFG6GXE1S	
What amenities are available at each CINÉPOLIS location	I do not know what amenities are available 	A2NI2HSU84PHJW
What if I just want to send a check for my purchase 	I do not know what will happen if you send a check for your purchase 	AE9M4Z1NCYSDM	
What should I do if I forget my account Password	I do not know what can be done if you have forgot your account password 	A234VIHHUHPZG5
CAN MEMBERSHIPS BE SHARED	I do not know if memberships can be shared 	A1BWNS27NA1JAP
What are the benefits for silver membership 	I do not know what the benefits are for silver membership 	A1GAARR4GOOZCO	
How much does ZooLights cost for members 	I do not know how much ZooLights costs for members 	A1XNCA1SVTT15B
Will you help me find chapstick	I am not able to help you find your chapstick 	A1IMXDZOTXABBE	
Are your cabinets fully assembled or ready to assemble -LRB- RTA -RRB- 	I do not know if the cabinets are fully assembled or ready to assemble -LRB- RTA -RRB- 	A18RMWE4BKHG6R
Is it easy to learn	I do not know if it is easy to learn 	A298FAWY76NZA9
Is Membership a value for me	I do not know if membership is a value for you 	A1JBSFXMMRGSQD
Do you sell rock hammers , tumblers or other rock hounding equipment 	I am not able to sell rock hammers , tumblers , or other rock hounding equipment 	A11TABPKSVOOFT
Can I use united.com check-in when I have bags to check 	I do not know if you can use united.com to check-in when you have bags 	A9A2IX3OBORBE
Will you provide a return shipping label 	I do not know if we provid a return shipping label 	AD9O852KPYLHY	
How many slots are available 	I do not know how many slots are available 	A13GUTDMGGZZDL
Any good ingredients are in belVita Breakfast Biscuits , Golden Oat 	I do not know if there are any good ingredients in belVita Breakfast Biscuits or Golden Oat 	A7SXWHGK8B40R
What is Intel ® Threading Building Blocks -LRB- Intel ® TBB -RRB- 	I do not know what Intel ® Threading Building Blocks -LRB- Intel ® TBB -RRB- is 	ABWW1P7GZ4C0Z
I was thinking a 2 story house , can you show me some 	I am not able to show you a 2 story house 	3PR3LXCWSFRFXJF8JUDNLS1BB1TX9Q
Does the name on my airline reservation have to match the name on my application 	I do not know if the name on your airline reservation has to match the name on your application	ATQD23E8ESFSI
What will I need to do to add my daughter to my automobile policy 	I do not know what you will need to do to add your daughter to your automobile policy 	A8F4B0854KTXO	
How does the guest/caregiver benefit work 	I do not know how the guest/caregiver benefit works 	AZLZA0Q87TJZO
The party includes all day admission , when can my guests arrive 	I do not know when your guests can arrive	APF1EAZT104LQ
How much for the special today 	I do not know how much the special is today 	A3VV5FFG6GXE1S	
I received the dress that I ordered from your company . There is a flaw in the dress and I need to know how to send it back for a refund . Can you help me on this 	I do not know if I can help you with this 	3HFWPF5AK9BLM04T8B6QV7HXWUHS3W
What should I wear/bring for Class	I do not know what you should wear/bring to class 	A3E3J27LF4OX9M
How can I get a copy of my driving record or vehicle records 	I do not know how you can get a copy of your driving record or vehicle records 	A1JBSFXMMRGSQD
I have taken a photograph of ' The Thinker ' by Rodin in the museum 's front garden . Is it possible to use this picture 	I do not know if it is possible to use this picture	APF1EAZT104LQ
I have a package being shipped , are you able to check on its status 	I am not able to check on its status 	A185P3B2MC2K83
How do I reset my My JH password 	I do not know how you reset your My JH password 	A2VIKCIM9TZL22
How do I tell the difference between honeybees and other stinging insects 	I do not know how to tell the difference between honeybees and other stinging insects 	A2VIKCIM9TZL22
Is the Berkshire Museum changing their mission statement 	I do not know if the Berkshire Museum is changing their mission statement 	A1JBSFXMMRGSQD
As a Member , do I get preferred parking 	I do not know if a member would get preferred parking 	A3O4VPJT4GOBMB
When can I expect my refund 	I do not know when you can expect your refund 	A1YKWG46AWMPUX	
Does this car have a back up camera 	I do not know if this car has a back up camera 	A9LX66EQWDRQ5	
How much of your products are made from recycled materials 	I do not know how much of our products are made from recycled materials 	AE9M4Z1NCYSDM	
Where do I find the Trinity Salary Scales 	I do not know where the Trinity Salary Scales are 	AF1VPADWTM40W
Can my item come in a custom box 	I do not know if your item can come in a custom box 	A2YQAE441JMA7V	
I have n't seen any confirmation emails . Why I am not receiving emails 	I do not know why you have not received your confirmation emails 	A1HLG5NN2I16GN
I want to change my phone number but it says my new one is in use by another customer 	I do not know how to change your phone number if it is in use by another customer 	A9LX66EQWDRQ5	
Can I bring my dog/pet 	I do not know if you can bring your dog/pet 	A3RD486RQUI2XV
Do you have a recital each year and are all dancers required to participate 	I do not know if there is a recital each year 	A2NI2HSU84PHJW
What is Estate Recovery 	I do not know what Estate Recovery is 	A8O98QNRG9SHV
Who are your reciprocal partners 	I do not know who are my reciprocal partners	A16184N1RO5OJV
I am having an event . Can I get a donation 	I do not know if you can get a donation 	A13GUTDMGGZZDL
What do I do if I need special accommodations 	I do not know what you should do if you need special accommodations 	APC99TPURUHR8
What if we need to cancel 	I am not able to cancel 	A3RKYD8IUC5S0N
Is there a discount for residents 	I do not know if there is a discount for residents 	A3R71HP45TBQ7O
How do I apply for a position 	I do not know how you can apply for a position 	A3G2FBKYCRD5Q8
Can I email statements from DanceStudio-Pro 	I do not know if you can email statements from DanceStudio-Pro 	AZLZA0Q87TJZO
I have followed the booking procedure but I have n't received the voucher , what can I do 	I am not able to tell you what you can do if you followed the booking procedure but have n't received the voucher 	A1JBSFXMMRGSQD
Will an invoice be included with my order 	I do not know if an invoice will be included 	A3722NOMVUK89T
I want to visit the museum with a group of people ; do you offer a group discount 	I do not know if there are group discounts 	A2NI2HSU84PHJW
Is workplace bullying against the law 	I do not know if workplace bullying is against the law 	A1X3SF2W1QQBY1
I would really appreciate it if you could install the equipment tomorrow seeing as how your tech just totally blew me off today . He did n't even notify me he would n't be coming 	I am not able to schedule n install for you tomorrow 	3K3G488TR20CNZCKUQ5EF40GS2NQ5V
Can you change my shipping method from Fedex Ground to Fedex Home Delivery so that my package will be delivered on Saturday 	I am not able to change your shipping method	APF1EAZT104LQ
Can you buy tickets online 	I do not know if you can buy tickets online 	A7SXWHGK8B40R
I 'm taller than average , do you have a larger version of product 	I do not know if we have a larger version of product 	AD9O852KPYLHY	
When does my Membership arrive 	I do not know when the membership will arrive 	A2NI2HSU84PHJW
I am interested in applying for clerical/administrative support work . Are there any special requirements 	I do not know the special requirements 	A2NI2HSU84PHJW
How can I email corporate 	I do not know how you can email corporate 	AGQPTDG6ZF3T3
Once I make a reservation , are there any fees involved if I need to cancel or make changes 	I do not know if there are any fees involved if you need to cancel or make changes	3NZ1E5QA6ZTPJTAVB88OKF5H62N5BZ
Can you please reactivate my account 	I am not able to reactivate your account 	AD9O852KPYLHY	
Can I change the cake flavor for the Wilson wedding on the 29th from vanilla to chocolate with the buttercream frosting 	I do not know if you can change the cake flavor for the Wilson wedding on the 29th from vanilla to chocolate with the buttercream frosting	3LCXHSGDLTYOWYKQXVNMEYLUNJ7SEN
Can we bring our own strollers and/or wagons 	I do not know if you can bring your own strollers and/or wagons 	A2K9PB0U45O0MU
What ages to you teach 	I do not know the ages we teach 	A2K9PB0U45O0MU
How long have we been in this building 	I do not know how long we will be in this building 	A16NITTBMCSN0V
What evidence does an employer need to investigate a claim of harassment 	I do not know what evidence an employer needs to investigate a claim of harassment 	A2NI2HSU84PHJW
Do you charge for parking 	I do not know if we charge for parking 	APC99TPURUHR8
Do I need to take a drivers ed course 	I do not know if you need to take a drivers ed course 	A2HKTM4Z8652
Do these soak up water well	I do not know if these soak up water well 	A31A4YKVSOYRVS	
For what time periods does Congress.gov have legislative information 	I do not know what time periods Congress.gov has legislative information 	A3CL6GEDFNQGQY
Are dependents covered under a group health plan eligible for continuation coverage under the Consolidated Omnibus Budget Reconciliation Act -LRB- COBRA -RRB- 	I do not know if dependents covered under a group health plan are eligible for continuation coverage under the Consolidated Omnibus Budget Reconciliation Act -LRB- COBRA -RRB- 	A3I9FTHSULHPYS
Can I stay with the same partner	I do not know if you can stay with the same partner 	A1X3SF2W1QQBY1
What do I need to have ready at my school for Zoo on Wheels 	I do not know what you need to have ready for Zoo on Wheels 	A13GUTDMGGZZDL
What can I do in My Verizon 	I do not know what you can do in My Verizon 	A1JBSFXMMRGSQD
hat are the characteristics of big bucket schedule items 	I do not know what are the characteristics of big bucket schedule items 	A3CL6GEDFNQGQY
I never ordered anything last week , but I got a charge 	I do not know why you got a charge	A23CTGXNDDW5LC	
My spouse and I are filing separate returns . How do we split our itemized deductions 	I do not know you split your itemized deductions if you and your spouse are filing separate returns 	A16VTK6KZ1U69H
When I went to the bank last week it was too crowded , I had to give up . Is that possible to make an appointment in advance 	I do not know if it 's possible to make an appointment in advance 	3FCO4VKOZ452D00Y9SPBJ7PY05V7EG
Where 's the nearest restroom and changing station 	I do not know where the nearest restroom or changing station is 	A2NI2HSU84PHJW
Can an employer charge any fees to employees who enroll in its paycard program 	I do not know if an employer can charge any fees to employees who enroll in its paycard program 	A2NI2HSU84PHJW
Do I have to specify the date I am visiting when purchasing tickets online	I do not know if you have to specify the date you are visiting when purchasing tickets online 	A3I9FTHSULHPYS
How does one go about changing the date of a flight to something a bit later ? I do n't need to get there that early	I do not know how one goes about changing the date of a flight to something a bit later	3BFNCI9LYKIZ32K1K88F0GL19G537L
Do you have an expedite process	I do not know if we have an expedite process	ATQD23E8ESFSI
How long will it take before I get my check in the mail 	I do not know how long it will take before you get your check in the mail 	A9LX66EQWDRQ5	
What wildlife is there in the National Park 	I do not know what wildlife there is in the National Park 	A2HKTM4Z8652
Are group discounts available 	I do not know if group discounts are available 	A2HKTM4Z8652
How do I get started with Amazon DynamoDB 	I do not know how you get started with Amazon DynamoDB 	A3G2FBKYCRD5Q8
Why do n't your preset answers include -LSB- fill in the blank -RSB- 	I do not know why our preset answers include -LSB- fill in the blank -RSB- 	AT7ADQKXKXEWY
Can you please provide the tracking number for my package 	I am not able to provide the tracking number for your package 	A8F4B0854KTXO	
I need to fly to columbus , can you tell me what airline to use 	I am not able to tell you what airline to use	3VZYA8PITOQOZ67LDSBZ0Y9YFYQ50D
I am out of shape . Do I need to lose weight before I try a Barre workout 	I do not know if you need to lose weight before you try a barre workout 	A2NI2HSU84PHJW
Is it easy to learn with the Arthur Murray system of teaching 	I do not know if it is easy to learn with the Arthur Murray system of teaching 	A1J0GU26323WVA
How may an agency implement a schedule item that has a flexible retention period 	I do not know how an agency can implement a schedule item that has a flexible retention period 	A1JBSFXMMRGSQD
Can I put my account on hold for a few months 	I am not able to put your account on hold for a few months 	A9LX66EQWDRQ5	
Why do I have to show a photo ID each time I visit 	I do not know why do you have to show a photo ID each time you visit 	A3SS1F4F3JE7CU
Will I save money on a 2018 Marketplace plan 	I am not able to definitively answer your question about whether or not you would save money on the 2018 Marketplace plan 	A13JQTLPWXZD6L
Can I print my own postage or do I need to fill out customs forms at the post office 	I do not know if you can print your own postage 	A3RD486RQUI2XV
Do you offer shipping discounts 	I do not know if we offer shipping discounts 	A31A4YKVSOYRVS	
What do the food & drink vouchers cover 	I do not know what the food and drink vouchers cover 	A2LQ9NP944M61Z
Does TrueCar sell or service vehicles 	I do not know if TrueCar sells or services vehicles 	A7SXWHGK8B40R
Can you tell me what the difference between this model is and your most expensive model 	I am not able to tell you what the difference is between this model and our most expensive model 	A325WS381BHOHH	
If a department wants a wall clock who will pay for it and what is the process of ordering on 	I do not know what the process of ordering a wall clock is or who will pay for it if a department wants one 	A2HKTM4Z8652
What is the construction happening at the Museum 	I do not know what the construction happening at the Museum is 	A1X3SF2W1QQBY1
What other similar products do you offer 	I do not know what other similar products we offer 	A31A4YKVSOYRVS	
What should I do if I receive a Jury Summons in the mail 	I do not know what you should do if you receive a Jury Summons in the mail 	A3RD486RQUI2XV
I am traveling with my family ; can they also use the TSA Pre ✓ ® lane 	I do not know if your family can use your TSA Pre ✓ ® lane 	A2LQ9NP944M61Z
Why is my job paid differently when compared to another University 	I am not able to tell you why your job is paid differently when compared to another University 	A1JBSFXMMRGSQD
Can you tell me what the sale price of your shoes are 	I am not able to tell you what the sale price of our shoes are 	A325WS381BHOHH	
Where do I go to change my shipping address 	I do not know where you go to change your shipping address 	A325WS381BHOHH	
Do you offer rentals for moving trucks 	I do not know if we offer rental trucks for moving 	A325WS381BHOHH	
What do you consider your ' dance year ' 	I do not know what I 'd consider my ' dance year ' 	APC99TPURUHR8
I am interested in one of your online only sales but I do n't have a credit card . Can I pay with my bank info 	I do not know if you are able to pay with your bank information 	34F34TZU7WR32FPKHHJ7KWLIUX52JG
Can we take pictures in the museum 	I do not know if you can take pictures at the museum 	A2LQ9NP944M61Z
Do you have a rewards program that I can utilize 	I do not know if we have a rewards program that you can utilize 	AE9M4Z1NCYSDM	
Do schools get discount admission to visit the Zoo 	I do not know if schools get discount admission to visit the zoo	A23CTGXNDDW5LC
I 'm a Louisville Zoo member . Do I pay a parking fee 	I do not know if you pay a parking fee	A23CTGXNDDW5LC
Are you hiring 	I do not know if we are hiring 	A3VV5FFG6GXE1S	
What subscriptions options are available for your service 	I do not know what subscription options are available with our service 	ASFR82SJYMGNU
I 'd like to send a special message along with the package 	I do not know how to send a special message along with the package 	A3RD486RQUI2XV
Does the Museum have a cafe 	I do not know if the Museum has a cafe 	A3I9FTHSULHPYS
Can I customize my monthly subscription 	I am not able to customize your monthly subscription 	AE9M4Z1NCYSDM	
I 'm having difficulty deciding which position is the best fit . Is there someone I can speak with to get more information 	I do not know who you can speak to to get more information 	A2NI2HSU84PHJW
What is my monthly payment 	I do not know what your monthly payment is 	A325WS381BHOHH	
Does my theatre offer a student discount 	I do not know if your theatre offers a student discount 	A2K9PB0U45O0MU
Do I get to choose where my vehicle is repaired 	I do not know if you get to choose where your vehicle is repaired 	ARKAJ6PL85CME
I have a 30 $ gift card that was included in the family plus and pride level memberships . Is it still valid 	I do not know if it is valid 	A1DWQO9X2ZQ35G
How is Crystal Bridges tied to Walmart 	I do not know hoe crystal bridges is tied to Walmart	APF1EAZT104LQ
What metrics can be used to determine the effectiveness of succession planning 	I do not know which metrics can be used to determine the effectiveness of succession planning 	A2NI2HSU84PHJW
I have a great idea for a show , and would like to work on it with the Center for Puppetry Arts . What do I do 	I do not know what you should do if you have a great idea for a show and would like to work on it with the Center for Puppetry Arts 	A2HKTM4Z8652
Should I be worried about the noise coming from the back of the rental car ? Is that normal 	I do not know if you should be worried about the noise 	30EMX9PEVKBRIYC0THYPCTYZ7G3SK7
Why do adults need to pay admission at a children 's museum 	I do not know why adults need to pay admission at a children 's museum 	A3U6CLX7HD0SMF
What time will the parcel be delivered 	I do not know what time the parcel will be delivered 	AD9O852KPYLHY	
How can I check the status of my appointment online 	I do not know how you can check the status of your appointment online 	A1J0GU26323WVA
Does ICE 's policy sensitive locations policy remain in effect 	I do not know if ICE 's policy sensitive locations policy remain in effect 	A1J0GU26323WVA
I would like to return an item , but I am not sure if I will have to pay anything for it . Can you help 	I am not able to tell you if your are going to be paying for it 	33NKDW9FFXAHVHMBVENENI2JHMWXC7
Is there a way to sign up for job alerts and be notified of future opportunities with Dell 	I do not know if there is a way to sign up for job alerts and be notified of future opportunities with Dell 	A2K9PB0U45O0MU
If I need to change the person picking up my order , how do I do that 	I am not able to help you change the person picking up your order 	3SU800BH86KT8E2ZVRDMNGSWRJGUQH
My item arrived damaged ! What can I do 	I do not know what you can do for your item that arrived damaged 	AE9M4Z1NCYSDM	
Can you help me place an order for two rolls 	I am not able to help you place an order for two rolls 	A3RD486RQUI2XV
Who is eligible for reciprocal admission benefits 	I do not know who is eligible for reciprocal admission benefits 	AF8KEA2127EAN
If an employer is unsure whether an employee gave notice of his or her intent to take Family and Medical Leave Act -LRB- FMLA -RRB- leave , must the employer inquire further 	I am not able to tell you if the employer needs to inquire further	APF1EAZT104LQ
Is there an ATM at the Court 	I do not know if there is 	A1DWQO9X2ZQ35G
What is the monthly cost of renting router from your company ? Is the delivery both way included 	I do not know what the monthly cost is 	3Y40HMYLL1ADHB3BH58EHOOPOM3UXE
Is the Museum devoted exclusively to the art of Eric Carle 	I do not know if the Museum is devoted exclusively to the art of Eric Carle 	A2EJ7U3TZAKROG
This item I ordered is defective and needs to be returned . Can you show me how to return the item 	I am not able to help you with a return 	367O8HRHKG064WNX8PB95C93AUDS4H
Do I need a motorcycle license to ride a scooter or moped 	I do not know if you need a motorcycle license to ride a scooter or a moped 	AQ9Y6WD8O72ZC
How can I request for tax exemption on my bill 	I do not know how you can request for tax exemption on your bill 	A2HKTM4Z8652
Who provided input during the creation of the DivX DRM system 	I do not know who provided input during the creation of the DivX DRM system 	APC99TPURUHR8
Is the museum available for event rental or weddings 	I do not know if the museum is available for event rental or weddings 	A2EJ7U3TZAKROG
Is there a grace period for DACA recipients with EADs that will soon expire to make appropriate plans to leave the country 	I do not know if there a grace period for DACA recipients with EADs that will soon expire to make appropriate plans to leave the country	A355BVFIOODRH2
What are parabens and why does Beiersdorf use them 	I do not know what parabens are or why Beiersdorf uses them 	A13GUTDMGGZZDL
I am just wondering if I could change the due date for my bill 	I do not know if you could change the due date 	A1J17BE20G6DKA
Can I talk to your supervisor about this please 	I am not able to let you talk to my supervisor 	A325WS381BHOHH	
How can I be sure that it is the same room type 	I do not know how you can be sure that it is the same room type 	A2NI2HSU84PHJW
How do I purchase a gift membership 	I do not know how you purchase a gift membership 	A1AF392CLGHH0X
Can we bring our dog to the Zoo 	I do not know if you can bring your dog to the Zoo 	A3R71HP45TBQ7O
Do we do the challenge as a team or individually 	I do not know if you do the challenge as a team or individually 	A16VTK6KZ1U69H
Does the Conservatory offer talent awards 	I do not know if the Conservatory offers talent awards 	A1HLG5NN2I16GN
What does Kemppi mean 	I do not know what Kemppi means 	ABN6GDFW4N8AK
Can I visit the museum and go to a Pavilion Stage concert on the same day 	I do not know if you can visit the museum and go to a Pavilion Stage concert on the same day 	A2115OWJ0CKOB3
I ca n't print my tickets at home . What should I do 	I do not know what you should do	A23CTGXNDDW5LC
Are you able to accommodate my child with medical allergies and/or special needs 	I am not able to accommodate your child 	A298FAWY76NZA9
Will I get admitted 	I do not know when you will be admitted 	A280TORYM293P6
What if I forget my login info	I am not able to help you if you forget your login info 	A3RD486RQUI2XV
Do you have many of these items in stock , or will they run out soon 	I do not know if we have many of these items in stock or if they will run out soon	A23CTGXNDDW5LC
What if I have been home schooled 	I do not know what occurs if you have been home schooled 	A1JBSFXMMRGSQD
I will be coming into town this weekend and wanted to stop at your store but you will be closed a couple of minutes earlier than I can get there . Can you stay for a couple of extra minutes to help me out 	I am not able to stay	31YWE12TE04BJ0RF4XF37WA5GB5X7E
I have lost or misplaced my membership card . How can I request a replacement 	I do not know how you can request a replacement card 	A3R71HP45TBQ7O
Where can I find online coupons	I do not know where you can find online coupons 	A3RD486RQUI2XV
what happens to my resume once I submit it to randstad professionals HR 	I do not know what happens to your resume once you submit it to randstad professionals HR 	A2VIKCIM9TZL22
Are you able to ship outside the United States 	I do not know if we are able to ship outside the United States 	A31A4YKVSOYRVS	
Who do I contact regarding questions 	I do not know who you contact regarding questions	A1GNG0J27JYSUB
Does this come in another color 	I do not know if this comes in another color 	A3DFNKXIOUFL23	
Will I receive a confirmation of my order 	I do not know if you will receive a confirmation order 	A3722NOMVUK89T
Is gift packaging available 	I do not know if gift packaging is available 	ASFR82SJYMGNU
How will I know if my online application was submitted successfully 	I do not know how you will know if your online application was submitted successfully 	A3I9FTHSULHPYS
Can my children bring a scooter 	I do not know if your children can bring a scooter	APF1EAZT104LQ
Why do pets scoot 	I do not know why pets scoot 	A7SXWHGK8B40R
I would like to buy a cartoon artwork , do you sell 	I do not know if we sell cartoon artwork 	A3G2FBKYCRD5Q8
Do I need to speak Japanese 	I do not know if you need to speak Japanese 	AT7ADQKXKXEWY
I need to have some work done on my Jeep . Can I schedule an appointment and reserve a loaner for the day 	I do not know if you can schedule an appointment and reserve a loaner for the day	A23CTGXNDDW5LC
Can you make sure this package I ordered gets sent to another location ? I recently moved and forgot to update it	I am not able to make sure this package you ordered gets sent to another location	3XQ4XW3OD94W1I8A4BSLCXC5QGHS2L
Do you offer financing 	I do not know if we offer financing 	A3RD486RQUI2XV
Do you guys do gift wrapping 	I do not know if we do gift wrapping 	A31A4YKVSOYRVS	
Why are there so many different labels , some of which are confusing or illegible 	I do not know why there are so many different labels , some of which are confusing or illegible 	A3U0VQ420HIMQ0
Will I receive a phone call or do I have to call you guys 	I do not know if you will receive a phone call 	A3FIJGXCWIHHQ5	
Can I change my award ticket 	I do not know if you can change your award ticket 	A13GUTDMGGZZDL
I have a ticket without an entry date and time . Will you accept it	I do not know if we will accept a ticket without any entry date and time 	A2HKTM4Z8652
I have not received my item in the mail yet , when should it arrive 	I do not know when it should arrive 	A2NI2HSU84PHJW
Having issues purchasing tickets online 	I do not know what you should do if you are having issues purchasing tickets online 	A9LX66EQWDRQ5
When do you guys run your holiday sales 	I am not able to tell you when we run our holiday sales 	A3RD486RQUI2XV
Are there some sort of zoning laws or can I build it without a permit 	I am not able to help you with the zoning laws 	A3RD486RQUI2XV
What is the procedural time limit relating to the applications of the family members of Hungarian citizens and EEA nationals , and for how long the residence card is valid 	I do not know what the procedural time limit relating to the applications of the family members of Hungarian citizens and EEA nationals is , or how long the residence card is valid 	A3RD486RQUI2XV
What is MyChart 	I do not know what MyChart is 	A1R1J3GL0YP7DJ
What is the lifetime learning credit 	I do not know what the lifetime learning credit is	A23CTGXNDDW5LC
How often do the train rides run 	I do not know how often the train rides run	APC99TPURUHR8
What should my application consist of 	I do not know what the application should consist of 	A2NI2HSU84PHJW
My child is a transfer student with previous dance experience . How do you place her/him in the appropriate level 	I do not know how to place your child in the appropriate level 	A2K9PB0U45O0MU
Can I use my gift card online and in store 	I do not know if you can use your gift card online and in store 	A31A4YKVSOYRVS	
What support can I get if I have a problem or any other question 	I am not able to tell you what support you can get if you have a problem or other question 	A2UBEPT605E8T2
I 'd like to make an addition to my order and have it shipped with the main item I ordered . How can I do this 	I do not know how to make an addition to an existing order 	367O8HRHKG064WNX8PB95C93AUDS4H
What is the difference between Airport transit visa and Transit visa 	I do not know the difference between the airport transit visa and transit visa 	A2NI2HSU84PHJW
Can you validate that you received my claim 	I am not able to validate that I received your claim 	AD9O852KPYLHY	
What is your average wait time 	I do not know what our average wait time is 	A325WS381BHOHH	
What should I do in the case of a family status change 	I do not know what you should do in case of a family status change 	AHJYLSDFBLEWM
If our new hire wishes to decline our health coverage , can the insurance fees not be automatically withdrawn from her pay 	I do not know if the insurance fees can not be automatically withdrawn from her pay	3XD2A6FGFNM712T9PK70MKKJWMS9SV
Does the court appoint a lawyer to represent me 	I do not know if the court will appoint a lawyer to represent you 	A1J0GU26323WVA
Where can I find support 	I do not know where you can find support 	A1J0GU26323WVA
Can anyone use the collection files for research 	I do not know if anyone can use the collection files for research 	A7SXWHGK8B40R
I recently moved to a new city and forgot to change my shipping address . Can I have this package re-routed to my new address 	I do not know if the package can be re-routed 	36BTXXLZ2V0U3HNKT0B4F247OSV4R6
How much do you charge if I would like to locate a vehicle 	I do not know how much we charge to locate a vehicle 	A1XNCA1SVTT15B
how do i redeem my travel points 	I do not know how you redeem your travel points 	A31A4YKVSOYRVS	
Can I bring a lunch and eat on the grounds 	I do not know if you can bring a lunch and eat on the grounds 	A2UBEPT605E8T2
What do you offer for children throughout the year 	I do not know what is offered for children throughout the year 	A235UQRA8GE18X
I need a copy of a document or a form . Who do I contact 	I do not know who you should contact	APF1EAZT104LQ
What should I do if someone is abusing the chat feature 	I do not know what you should do if someone is abusing the chat feature	ATQD23E8ESFSI
Why do we have to pay full tuition every month 	I do not know why you have to pay full tuition every month 	A1J0GU26323WVA
What kinds of educational activities can I do with my kids/class/camp group 	I do not know what educational activities you can do with your kids/class/camp group 	A2VFX3J4B1I22X
I need to check on my walmart order , can you tel me how I do that 	I am not able to tell you how to do that 	3D4BBDG7ZHO5FJFXBPGQG2DFARW3CE
How does vacation balance transfer to correct absence type for an employee who transfers from one pay group to another -LRB- i.e. from biweekly to monthly ; from union to non-union -RRB- 	I do not know how vacation balance transfers to correct absence type 	A3THR2UWGQNVX4
How many paid holidays and vacation days do Fairfax County employees receive per year 	I do not know how many paid holidays and vacations days employees receive 	A325WS381BHOHH
The item I received is damaged . How do I return it and will I be reimbursed 	I do not know how you can return it 	341YLJU21IR7745EZZY78V6IHIG2I4
Can I find the instructions online 	I do not know if you can find the instructions online 	A1YKWG46AWMPUX	
When is it appropriate to give no increase 	I do not know when it is appropriate to give no increase 	A1S8DYWNS59XWB
Can you tell me if you can order this in custom colors 	I do not know if you can order this item in custom colors 	A31A4YKVSOYRVS	
Where can I see the status of my application 	I do not know where you can see the status of your application 	A7SXWHGK8B40R
What is the admission charge 	I do not know the admission charge 	A1RVRBKEQL1ZPG
Do you offer any type of perks or rewards for being a loyal customer 	I do not know if we offer any type of perks or rewards for being a loyal customer 	A3GNQDFPZALU92	
How are applicants with alumni relatives or ' legacies ' handled in Vanderbilt ' s admissions process 	I do not know how alumni relatives are handled in the Vanderbilt admissions process 	A1HLG5NN2I16GN
How do I change my account information 	I am not able to tell you how to change your account information 	AE9M4Z1NCYSDM	
What is wearable technology 	I do not know what wearable technology is 	A3I9FTHSULHPYS
Are there any places to buy a meal or snacks 	I do not know if there are any places to buy a meal or snacks 	A1JBSFXMMRGSQD
May an employer make deductions to an employee 's salary without jeopardizing the employee 's exempt status 	I do not know if an employer may make deductions to an employee 's salary without jeopardizing the employee 's exempt status 	A9LX66EQWDRQ5
Do we have a restaurant or café and if not what are the nearest ' nice ' places to eat 	I do not know if we have a restaurant or cafe , or what the nearest nice places to eat are 	A2K2MFQMN31DZ
Can I register for my wedding here 	I do not know if you can register for your wedding here 	A3VV5FFG6GXE1S	
Can you text me when you get this model back in stock 	I am not able to text you when we get this model back in stock 	A3RD486RQUI2XV
Could you update my email address on your system please , I 've just changed it 	I am not able to update your email address on our system 	A31A4YKVSOYRVS	
I realized I need my order sooner . How can I change the shipping on my order 	I do not know how you can change the shipping on your order 	3UEBBGULPFGWHPCQHB2SBHOIKH7UFN
The tracking number for my package is incorrect as it shows someone else 's address for the delivery . How can I correct this 	I do not know how you can correct this	31KPKEKW4A5QOMOUE22C3K9QPUC0B9
Where are disabled parking spaces located 	I do not know where the disabled parking spaces are located 	ARKAJ6PL85CME
I 'd like to change my credit card info on my account 	I do not know how to change your credit card info on your account 	A185P3B2MC2K83
Can I change the address I want the package to be delivered to before it ships out 	I do not know if you can change the delivered to address on the package before it ships 	A3SSJNH5SIZUPG	
Do you have an ATM 	I do not know if we have an ATM 	AZLZA0Q87TJZO
What if I do not show up for my award reservation 	I am not able to tell you what happens if you do not show up for your award reservation 	A5VBIZ2KIQ1R8
Why is jury service important 	I do not know why jury service is important 	A1JBSFXMMRGSQD
I 'm supposed to bring my cat in tomorrow for shots , but she is seriously stressed , can I reschedule 	I do not know if you can reschedule 	322ZSN9Z5GC7JW0CXPGZFH5PCDS4TJ
What happens if I am selected for the position 	I do not know what happens if you are selected for the position 	A2HKTM4Z8652
I recently added a family member to my unlimited family plan , and my bill went up by twenty extra dollars this month . What changed my plan 	I do not know what changed your plan 	3FDWKV9VCNU2NZ473Y65678RHIJUMU
By what time do I have to order so that the shipment will leave your center the same day 	I do not know what time you have to order so that the shipments will leave our center the same day 	ASFR82SJYMGNU
Is it necessary to go to the Japanese Embassy / Consulate General by myself to apply for a visa 	I do not know if it is necessary to go to the Japanese Embassy/Consulate General by myself to apply for a visa 	A7SXWHGK8B40R
Can I purchase online and have it shipped to the store 	I do not know if you can purchase online and have it shipped to the store 	AD9O852KPYLHY	
Can the zoo be rented for special events 	I do not know if the zoo can be rented for special events 	A2NI2HSU84PHJW
How is the Museum governed 	I do not know how much the Museum is governed 	A234VIHHUHPZG5
May an employer discipline an employee for off-duty behavior 	I do not know if an employer may discipline an employee for off-duty behavior 	ADDRUVU9CWJTG
Why was the med-pod only calibrated for male patients when there are several female crewmembers onboard the Prometheus 	I do not know why the med-pod was only calibrated for male patients when there are several female crewmembers onboard the Prometheus 	AZLZA0Q87TJZO
When I get his socks on , all he does is take them off again . My son is two now ; what can I do 	I do not know what you can do to persuade your son to keep his socks on 	37Y5RYYI0PXX2YB7S0DE2N613PIXS1
I was hoping you could help me with an insurance claim 	I am not able to help you with an insurance claim 	A3RD486RQUI2XV
Who do I need to talk to about getting Sponsored by DXRacer 	I am not able to tell you who you need to talk to about getting Sponsored by DXRacer 	A2UBEPT605E8T2
Why Do Cats Drool When Petted 	I do not know why cats drool when petted 	A16VTK6KZ1U69H
If I have a president 's circle membership or have added a plus one or plus two to my membership , do my guests receive a discount on luminous nights tickets	I do not know if your guests will receive a discount on luminous nights tickets 	A1X3SF2W1QQBY1
What is DanceSport 	I do not know what DanceSport is 	AZLZA0Q87TJZO
What 's the cost to ship to NY 	I do not know the cost to ship to NY 	A3RD486RQUI2XV
How are departments informed of the results of the criminal background check 	I do not know how departments are informed of the results of the criminal background check 	APC99TPURUHR8
How do I leave feedback for an order I just made 	I do not know how you would leave feedback for an order you just made 	A30YFEIPGXNWJL
How much for express shipping	I do not know how much express shipping is 	A3GNQDFPZALU92	
What is the phone number to the insurance agency ? I need to call them 	I am not able to help you with your agents phone number 	3HXCEECSQMLJ3FNVSOTOHUADSACZYE
May I offer an increase in salary for a lateral transfer/hire 	I do not know if you can offer an increase in salary 	A13GUTDMGGZZDL
Can a student make alcohol as part of a science fair project 	I do not know if a student can make alcohol as part of a science fair project 	A1IMICF9ISISZN
Does matcha tea have caffeine 	I do not know if matcha tea has caffeine 	A2K9PB0U45O0MU
Intel makes processors -- how does that relate to software 	I do not know how Intel making processors relates to software 	A3RO0QIXW4IX3Y
Do any large whales have teeth 	I do not know if large whales have teeth 	A3EJ2U51X7CLYW
I had my order shipped to my home but I want to pick it up instead , how do I do this 	I do not know how you do this	3VZYA8PITOQOZ67LDSBZ0Y9YFYQ50D
Are there video screens	I do not know if there are video screens 	A116N2LEI6O7HB
Could you please tell me how much I owe 	I am not able to tell you how much you owe	A23CTGXNDDW5LC
Can I make an appointment to get an oil change 	I am not able to make you an appointment to get an oil change 	A31A4YKVSOYRVS	
When prompted , should I ' Open ' or ' Save As ' my purchased video 	I do not know what you should do 	A1DWQO9X2ZQ35G
What is the best time to reach technical care 	I do not know the best time to reach technical care 	A3RD486RQUI2XV
Can you help if I 've lost my card and need help reordering 	I am not able to help if you 've lost your card and need help reordering	A23CTGXNDDW5LC
When will my order arrive 	I do not know when your order will arrive 	A9LX66EQWDRQ5	
Can I still purchase tickets at the gate if the event sells out in advance 	I do not know if you can purchase tickets at the gate if the event sells out in advance 	A1A0PNOBFTTHGP
Can I bring my own food/picnic 	I do not know if you can bring your own food/picnic 	A2K2MFQMN31DZ
Does the drone fly over 100 feet high	I do not know if the drone flies over 100 feet high 	A9LX66EQWDRQ5	
Why is Lodge Enamel Made in China 	I do not know why Lodge Enamel is made in China 	A2K9PB0U45O0MU
Can I book flights for multiple-stop itineraries online 	I do not know if you can book flights for multiple-stop itineraries online 	A2UBEPT605E8T2
Do you have the number of the shipper 	I do not know the number of the shipper 	A325WS381BHOHH	
What if I have trouble using your online ticketing 	I do not know what you should do if you have trouble using our online ticketing 	A2VIKCIM9TZL22
I was given these tickets as a gift , but the person who gifted them has passed away . How do I get the tickets 	I am not able to assist you in getting the tickets 	AADRVG2QVZH75	
If I want my product here by Friday , which shipping method should I select 	I do not know which shipping method you should select 	ASFR82SJYMGNU
How do I view the video tutorials 	I am not able to tell you how to view the video tutorials 	A3RD486RQUI2XV
Will I be able to return my item to a store or do I have to ship it back 	I do not know if you will be able to return your item to a store 	A9LX66EQWDRQ5	
Can I bring food and drinks to the Zoo 	I do not know if you can bring food and drinks to the Zoo 	A116N2LEI6O7HB
Do my children require US passports 	I do not know if your children rrequire US passports 	A13JQTLPWXZD6L
What programming is available for school groups 	I do not know what programming is available for school groups 	A9LX66EQWDRQ5
What is the cost of the renter 's insurance if I live in gated apartment complex ? Is there any discount 	I do not know the cost of renter 's insurance for your situation 	3NRZ1LDP7WYPU1VU11X543H1O59PZA
What information do I have to provide to become an UMMA Free Member 	I do not know what information you have to provide to become an UMMA Free Member 	APC99TPURUHR8
Can I have a party in my room 	I do not know if you can have a party in your room 	A3G2FBKYCRD5Q8
How do I play Switch Zoo 	I do not know how you play Switch Zoo 	A13GUTDMGGZZDL
I want to upgrade my phone plan and I need to find out more better deals 	I do not know if I want to upgrade my phone plan and I need to find out more better details	3X878VYTIEAUJE0U439H1PAYC6A7FY
What can I use for user name 	I am not able to tell you what to use for your user name 	A18RMWE4BKHG6R
At what temperature should I heat my water in a Staub teapot 	I do not know what temperature you should heat your water to in a Staub teapot 	A116N2LEI6O7HB
I need to change my address on my last order , can you tell me how to do this 	I am not able to tell you how to do this	3QI9WAYOGQ3KJJRBRD4O2ATH6LJS62
My packaged needs to be signed for but I wo n't be there on the delivery date . Can I leave a signed note with a friend and have them present it to the delivery person 	I do not know if you can leave a signed note with a friend and have them present it to the delivery person 	3087LXLJ6M8G130AJ4O8MA0B4S40FR
What do your contracts look like 	I do not know what our contracts look like 	A7SXWHGK8B40R
When I try to set up a new password for My Verizon , I get a message saying it 's not valid because it 's an easily guessed password . What does this mean 	I do not know what it means if you get a message saying your new password for My Verizon is not valid because it 's an easily guessed password 	AZLZA0Q87TJZO
Where can I find growing instructions for these roses 	I do not know where you can find growing instructions for these roses 	AE9M4Z1NCYSDM	
Is an employer required to accommodate an employee 's or applicant 's family responsibilities 	I do not know if an employer is required to accommodate an employee 's or applicant 's family responsibilities 	A7SXWHGK8B40R
Can my kids visit the museums without me 	I do not know if kids can visit the museums with you 	A11IEP7J8XSE1C
How long have I been a costumer here 	I do not know how long you have been a customer here 	A31A4YKVSOYRVS	
Does the Subaru Certified Pre-Owned program have a deductible 	I do not know if the Subaru Certified Pre-Owned programs has a deductible 	A116N2LEI6O7HB
I bought one of your digital products but I lost the product code , can you help me recover it 	I am not able to help you recover it 	AD9O852KPYLHY	
I accidentally purchased the wrong TV mount and destroyed the box . Is it possible that I could get a refund still 	I do not know if you can still get a refund 	3O71U79SRBHM8MC3ETB5R6Q3WLYSMC
Am I allowed to bring food into the zoo	I do not know if you are allowed to bring food into the zoo 	A325WS381BHOHH
How long does it take to see everything	I do not know how long it takes to see everything 	A2NI2HSU84PHJW
Are n't dance classes expensive 	I do not know if dance classes are expensive 	A27MJOV91GA8R3
I just bought a fan from your site and it 's making a tick tick ticking noise that just wo n't stop 	I do not know how to help you stop the noise 	3EAWOID6MTP5X0M0JJTC4W3XSMRV09
Can you tell me the name of the service agent that specializes in this situation 	I am not able to tell you the name of the service agent that specializes in this situation	APF1EAZT104LQ
Can I change my shipping speed after purchase 	I am not able to change your shipping speed after purchase 	AHGM882UX7S4T	
What browsers are supported 	I do not know what browsers are supported 	A6ZEHD61NRBWA
What is the quickest way to get my money back on a return ? Should I send it first class or overnight mail 	I do not know the quickest way to get your money back on a return 	3HEA4ZVWVDENUDTMAYHBHT5PW6155Y
I submitted an order for a yellow blouse , but my email confirmation mentions blue - can we check on the color to make sure it 's correct before it 's shipped 	I am not able to check the color of your shipment 	386T3MLZLNN7MOQNBQI2CIJPHOR08A
Why have n't you charged my credit card yet 	I am not able to tell you why we have n't charged your credit card yet 	A3VV5FFG6GXE1S	
I 'm going to be out of town next week - can you cancel my order for just that week 	I am not able to cancel your order for just that week 	A2EAJXBORHT44T	
Can you tell me if this particular necklace is on backorder or if I should just look elsewhere 	I am not able to tell you if a necklace is on backorder 	3X0EMNLXEPH8LHQK0482JX450U3PVA
I just got my shirt in the mail and it is the wrong size and color . How do I go about getting the correct item and you guys will pay for the return right 	I do not know how you get the correct item 	3NSCTNUR2ZFK0J535U8SP4LBOK25A4
Can I take an earlier tour if I arrive early 	I do not know if you can take an earlier tour if you arrive early 	A7SXWHGK8B40R
Can my child attend Camp with a friend 	I do not know if you child can attend Camp with a friend 	APC99TPURUHR8
What are the different types of employee awards and employee recognitions 	I do not know the different types of employee awards and employee recognitions 	A7SXWHGK8B40R
Can I sleep next to my partner or friend 	I do not know if you can sleep next to your partner or friends 	A2NI2HSU84PHJW
Hello . I would like to buy a new insurance but can you tell me whether any of your plans are a better deal than what I already have 	I am not able to tell you if any of our plans are a better deal than what you already have 	A3GNQDFPZALU92	
What is in the Museums permanent collection 	I do not know what is in the museums permanent collection 	A3RD486RQUI2XV
What types of people are selected as Fellows 	I do not know what types of people are selected as Fellows 	A1R1J3GL0YP7DJ
I have an item I want to exchange but I have no idea if I can exchange it because I received it as a gift 	I am not able to exchange an item that was received as a gift 	AMELZJ4P3IIJH
Can I choose when I receive the subscription box 	I am not able to let you choose when you receive the subscription box	APF1EAZT104LQ
When will my debit card arrive in the mail 	I do not know when your debit card will arrive in the mail 	A9LX66EQWDRQ5	
Can you tell me if you have special accounts designed for students at your bank 	I am not able to tell you if we have special accounts designed for students at our bank	3OWZNK3RYLHCGV0ETGNLRYUTBD32UC
What are the monthly access charges for smartphones , tablets and mobile hotspots on the Verizon Plan , and why are some of them different 	I do not know the monthly access charges for smartphones , tablets , and mobile hotspots on the Verizon Plan , or why some of them are different 	APC99TPURUHR8
What file format are the templates offered in 	I do not know what file format the templates are offered in 	A1J0GU26323WVA
Can you check if I qualify for the program 	I am not able to check if you qualify for the program 	A3U6CLX7HD0SMF	
What will your beginner learn	I do not know what our beginner will learn 	A16VTK6KZ1U69H
Does your store have a plus size department 	I do not know if we have a plus size department 	A1YKWG46AWMPUX	
How many people were registered as prisoners in Auschwitz 	I do not know how many people were registered as prisoners in Auschwitz 	A1A0PNOBFTTHGP
Could you please check my account ? I am concerned about a deposit I made . It is not showing on my statement 	I am not able to check your account	3ZLW647WALNSH1NVEWRK4P4TY0J325
How does TrueCar use information about me 	I do not know how TrueCar uses information about you 	A16NITTBMCSN0V
I had ordered check books some time ago . But I had not received them . Can you check the status for me 	I am not able to check the status	33W1NHWFYHDNMTO1II6P9DIYD8UZTP
What is Pacific known for 	I do not know the answer to your question 	AP4FDDWBJW47O
What are the qualifications of your teaching staff 	I do not know the qualifications of your teaching staff 	A3RD486RQUI2XV
What does your beginner need to dance	I do not know what your beginner needs to dance 	AJ7E01X4TAGHL
How many problems does the student complete in each lesson 	I do not know how many problems are completed 	A1JWNZLD7PS5NU
Do you have any foundation suitable for oily skin 	I do not know if we have any foundation suitable for oily skin 	A325WS381BHOHH	
I am ready to learn ! How do I get started 	I do not know how you get started 	A2K2MFQMN31DZ
Why is the shipping fee $ 32 	I do not know why the shipping fee is $ 32 	A16VTK6KZ1U69H
What kind of airplanes do you have at the Air Museum 	I do not know what kinds of airplanes we have here at the Air Museum 	A3U6CLX7HD0SMF
Can I add tip to the receipt or should I pay the tip in cash 	I do not know if you can add tip to the receipt 	AD9O852KPYLHY	
What is a Barre Workout 	I do not know what a Barre Workout is 	A16VTK6KZ1U69H
Where can I park when coming for a tour 	I do not know where you can park when coming for a tour 	A7SXWHGK8B40R
Where on the website can I find rentals for medical equipment 	I am not able to tell you where you can find rentals for medical equipment on the website	APF1EAZT104LQ
I was n't able to locate the tracking number on this order , could you please look that up for me 	I am not able to look it up for you 	3MG8450X2O28821KVEYXNB2MMNUPUL
Can I schedule a maintenance appointment 	I do not know if you can schedule a maintenance appointment 	AGQPTDG6ZF3T3
How do I communicate with my account manager or request IT advice 	I am not able to put you in contact with an account manager or request IT advice 	A16NITTBMCSN0V
What kind of works do you have in your permanent collection 	I do not know what kind of works we have in our permanent collection 	A2EJ7U3TZAKROG
I have been looking in to getting auto insurance , can you tell me if there are different insurance coverage types 	I am not able to tell you if there are different types 	3566S7OX5DB3TZ6MX4UWCN64BWR71X
When can I check into my room 	I do not know when you can check into your room 	A31A4YKVSOYRVS	
My keys will not work for my apartment , is the office still open so i can get another one 	I do not know if the office is still open so you can get another one	375VSR8FVW1A6EB9ET1U9YHGPNXRZ4
Do I really need an employee handbook	I do not know if you really need an employee handbook 	ARKAJ6PL85CME
Does Kirkland 's have a catalog 	I do not know if Kirkland 's has a catalog 	A3U6CLX7HD0SMF
Is there a grace period for late payments 	I do not know if there is a grace period for late payments 	A30YFEIPGXNWJL
What if I 'm visiting another zoo or aquarium 	I do not know what to do if you 're visiting another zoo or aquarium	APC99TPURUHR8
How can I get photographic prints or slides of Museum images 	I do not know how you can get photographic prints or slides of museum images 	A2NI2HSU84PHJW
What are the pros and cons of allowing e-cigarettes in the workplace 	I do not know the pros and cons of allowing e-cigarettes in the workplace 	A5VBIZ2KIQ1R8
Do you guarantee that we will see whales on the whale watching excursion 	I am not able to guarantee that you will see whales on the whale watching excursion	A23CTGXNDDW5LC	
Who should write my letter of recommendation 	I do not know who should write your letter of recommendation 	A2VIKCIM9TZL22
I would like to withdraw cash from my account 	I am not able to help you withdraw cash from your account 	A1YKWG46AWMPUX	
What if the student 's and teacher 's personalities do n't mesh well or the student is dissatisfied 	I do not know what to do if the student 's and teacher 's personalities do n't mesh well or the student is dissatisfied 	A3RD486RQUI2XV
Do people like working at Bamboo 	I do not know if people like working at Bamboo 	A325WS381BHOHH
Can you help check on my order 	I am not able to check on your order 	AJKA9BKC011F2
What is DivX Certified Device Registration 	I do not know what the DivX Certified Device Registration is 	A2K2MFQMN31DZ
Does BAMPFA offer art and film appraisal services 	I do not know if BAMPFA offers art or film appraisal services 	A2EJ7U3TZAKROG
What if my question is not answered on this page 	I do not know what to do if your question is not answered on this page 	AJ7E01X4TAGHL
I need to book a hotel for labor day weekend , I know this is short notice but are there any opening 	I do not know if there are any openings for Labor Day weekend 	3XBXDSS888BAYLGH8RGDQ1S6BVAXLN
Will dinner or breakfast be served 	I do not know will dinner or breakfast be served 	A3SS1F4F3JE7CU
How much is my order total 	I do not know how much your order total is 	A3GNQDFPZALU92	
Who should I contact about my tax query 	I do not know who you should contact 	A13GUTDMGGZZDL
What kinds of transportation fringe benefits may an employer offer its employees on a tax-free basis 	I do not know what kinds of transportation fringe benefits an employer may offer its employees on a tax-free basis 	A16VTK6KZ1U69H
If a candidate is found ineligible for employment based on the results of the background check , who may the department contact for further information 	I do not know who the department can contact for further information if a candidate is found ineligible for employment based on the results of the background check 	A1199EKUWHAKUQ
What is your companies website 	I do not know the website 	A260AFDCSXBQOH
How long after I receive a product do I have to return it 	I do not know how long after you receive a product you have to return it	A23CTGXNDDW5LC	
What if I do n't know the exact page of the census 	I do not know what to do if you do n't know the exact page of the census 	A2115OWJ0CKOB3
How much sex , violence , and profanity are in this movie 	I do not know how much sex , violence and profanity are in this movie	A2NI2HSU84PHJW
I placed an order last week , and it was scheduled to be delivered today . I checked my order status online and now it says it is on back order , can you please help me find out how it went from out for delivery to back-ordered status 	I am not able to check the status of your order 	39KMGHJ4RZ2P4ZLKGM5NJ3D7YQF00N
Could you take our appetizer off of our bill 	I am not able to take an appetizer off your bill 	A113OGTB578EF6	
It 's urgent that I get this package tomorrow morning 	I am not able to help you get this package tomorrow morning 	ASFR82SJYMGNU
If I am not a united.com Club member and I purchase the ticket for someone who is a united.com Club member , do they get the credit 	I do not know if they get credit 	A2NI2HSU84PHJW
I want to know what the cheapest offers are for flights to San Diego next month 	I do not know what the cheapest offers are for flights to San Diego next month	3UEDKCTP9VI5Z0S85E0EH223K2R7K0
Where can I enter the Museum for evening programs and lectures 	I do not know where to enter the Museum for evening programs and lectures 	AU3WB2DD4QJ4B
Is there an estimated time that goods typically arrive 	I do not know if there is an estimated time that goods typically arrive 	A9LX66EQWDRQ5	
How does ED define a ' comparable program of study ' when considering eligibility for a closed school loan discharge 	I do not know ED defines a ' comparable program of study ' when considering eligibility for a closed school loan discharge 	A2K9PB0U45O0MU
Can you help me find a job	I am not able to help you find a job 	AE9M4Z1NCYSDM	
At which location will I be working 	I do not know at which location you will be working 	A16VTK6KZ1U69H
Are there any days the museum is free admission 	I do not know if there are any days with free admission 	A2NI2HSU84PHJW
What do I wear to my first visit 	I do not know what you need to wear on your first visit 	A3U6CLX7HD0SMF
Can you please check on my package 	I am not able to check on your package	A23CTGXNDDW5LC	
What about a capsule hotel 	I do not know about a capsule hotel 	ARKAJ6PL85CME
Is there any trade-in program that gives a discount on new purchases 	I do not know if there are any trade-in programs that gives a discount on new purchases 	A1J0GU26323WVA
What are the private lessons 	I do not know what the private lessons are 	A1XNCA1SVTT15B
Does your restaurant offer any vegan options 	I do not know if our restaurant offers any vegan options 	ARCNENCVA0STW	
I do n't have any children but I am a kid at heart , can I come and enjoy the museum 	I do not know if you can come and enjoy the museum 	A3NZLRU95OULXB
I would like to know what your refund policy is 	I do not know what our refund policy is 	AMYD8PNSBQ7C2
Do you have parking facilities 	I do not know if we have parking facilities 	AT7ADQKXKXEWY
Can I change my due date 	I do not know if you can change your due date 	A3RD486RQUI2XV
What if I have questions about using ESS or wish to offer some feedback 	I am not able to help if you have questions about using ESS or wish to offer some feedback 	A1JBSFXMMRGSQD
I need to change the answers to my security questions on my account , please 	I am not able to change the answers to your security questions on your account 	A8F4B0854KTXO	
If I sign up for ticket for an event , what should I keep in mind 	I do not know what you should keep in mind if you sign up for a ticket for an event 	A3R71HP45TBQ7O
Are DivX Certified devices required to support DivX DRM 	I do not know if DivX Certified devices are required to support DivX DRM 	A16VTK6KZ1U69H
Do I need to be home to sign for my package 	I do not know if you need to be home to sign for your package 	A31A4YKVSOYRVS	
I missed my flight , Could you please change my hotel reservation to match my new itinerary 	I am not able to change your hotel reservation to match your new itinerary 	3IKMEYR0LWNYDZV2Z2JJLBLV9M52KF
I 'm waiting for a sale , are there any coming up 	I do not know if there are any coming up	A23CTGXNDDW5LC
What does ' Benefits Eligible ' mean 	I do not know what ' Benefits Eligible ' means 	A325WS381BHOHH
When I received my package today , one of the items was broken . May I get a replacement sent to me 	I do not know if you can get a replacement 	372AGES0I4XL1JBUDBD9CD15HNZXRD
Why is my order arriving in multiple packages 	I do not know why your order is in multiple packages 	AJNQ2PBD07FKE
I ordered the wrong size and I 'd like to cancel my order 	I am not able to cancel your order 	AHGM882UX7S4T	
What is the difference between ' document ' and ' non-document ' or ' product ' shipments for international shipping 	I do not know what the difference is between ' document ' and ' non-document ' or ' product ' shipments for international shipping 	A9LX66EQWDRQ5
Can we leave and come back 	I do not know if you can leave and come back 	A116N2LEI6O7HB
How soon can customer service get here 	I am not able to tell you when customer service can get there	APF1EAZT104LQ
I accidentally placed an order on the site and I was n't done shopping , how do I cancel it 	I am not able to cancel your order 	AJNQ2PBD07FKE
Is there parking at your location	I do not know if there is parking at our location 	A3U0VQ420HIMQ0
Is BPA found in your PET plastic bottles 	I do not know if BPA is found in our PET plastic bottles 	AZLZA0Q87TJZO
In terms of giving a gift , what is the difference between the new , renew and Gift Options	I do not know what the difference is between the new , renew , and gift options in terms of giving a gift 	A2EJ7U3TZAKROG
Can I change the font of the print view for Book 	I do not know if you can change the font of the print view for Book 	A1JBSFXMMRGSQD
What are the OSU Museum of Art Advocates 	I do not know what the OSU Museum of Art Advocates are 	A2HKTM4Z8652
Can I purchase a Community Value membership on a blackout date 	I do not know if you can purchase a Community Value membership on a blackout date 	A3CL6GEDFNQGQY
Can Zookeepers go into areas with the animals 	I do not know if Zookeepers can go into areas with animals 	A1JBSFXMMRGSQD
Can I change my subscription 	I do not know if you can change your subscription 	A3I9FTHSULHPYS
What 's your refund policy 	I do not know the refund policy 	AE9M4Z1NCYSDM	
Can the walker be the same person each day , so my dog gets used to him/her 	I do not know can the walker be the same person each day , so your dog gets used the them 	A3SS1F4F3JE7CU
When is the payment due 	I do not know when the payment is due 	A7SXWHGK8B40R
Why does it take so long to complete the hire process 	I do not know why it takes so long to complete the hire process 	A3I9FTHSULHPYS
If I submitted my order before I used the promo code , can I still have the promo code applied 	I do not know if you can still have the promo code applied 	AD9O852KPYLHY	
How do you make a contribution to reduce the debt 	I do not know how to make a contribution to reduce the debt 	A2EJ7U3TZAKROG
Will you accept an application after the closing date 	I do not know if I can accept an application after the closing date 	A3RO0QIXW4IX3Y
How much is daily admission 	I do not know how much daily admission is 	A3G2FBKYCRD5Q8
I am having trouble logging in online . Can you reset my password or do I need to talk to someone else 	I am not able to reset your password 	3P7QK0GJ3TDT2UUOZ3MT8Q98DVI2Z1
I recently moved , do I need to change my address with Benefits for my insurance 	I do not know if you need to change your address with benefits for your insurance 	A2NI2HSU84PHJW
Is my eye glass prescription still on file 	I do not know if your eye glass prescription is still on file 	A31A4YKVSOYRVS	
Do you offer gift wrapping 	I do not know if we offer gift wrapping 	AADRVG2QVZH75	
I just renewed my membership . What are my benefits now 	I do not know what your benefits are now	A23CTGXNDDW5LC
Where can I find more information about this company 	I do not know where you can find more information about this company 	A31A4YKVSOYRVS	
Can this item be returned once the box has been opened 	I do not know if the item can be returned once the box has been opened 	A3VV5FFG6GXE1S	
Can I bring pets or other animals to the BioPark 	I do not know if you can bring pets or other animals to the BioPark 	A3RD486RQUI2XV
How do I recognize the play money poker tables 	I do not know how you recognize the play money poker tables 	A16VTK6KZ1U69H
Help me locate the product recalls section on your website 	I am not able to help you locate the product recalls section on our website	A23CTGXNDDW5LC
What times do the tour buses leave 	I do not know what times the tour buses leave 	A31A4YKVSOYRVS	
Why are there different versions of bills 	I do not know why there are different versions 	A13GUTDMGGZZDL
What are your delivery times 	I do not know what our delivery times are 	A1J0GU26323WVA
Can I remove the credit link ' Joomla Templates by ZooTemplate.Com ' 	I do not know if you can remove the credit link ' Joomla Templates by ZooTemplate.Com ' 	A3G2FBKYCRD5Q8
How do I put an item on layaway 	I am not able to tell you how to put an item on layaway	AYJGJAIY0EXW
Do I need to purchase extra insurance 	I do not know if you need extra insurance	APF1EAZT104LQ	
How much might the Occupational Safety and Health Administration -LRB- OSHA -RRB- make an employer pay if it receives an OSHA citation 	I do not know how much OSHA would make an employer pay if it receives an OSHA citation 	A2D0IIX70FDQIW
Can my relatives or friends who do not live in my household be included on my membership card 	I do not know if your relatives or friends who do not live in your household can be included on your membership card 	A21EPR8KW0GWX2
Can I get an account on credit 	I do not know if you can get an account on credit 	A3RD486RQUI2XV
Please stop sending me catalogs 	I am not able to stop sending you catalogs	A23CTGXNDDW5LC	
What products are popular in my area 	I do not know what products are popular in your area	A23CTGXNDDW5LC
do you know when the next version of this phone will be released 	I do not know when the next version of this phone will be released 	AE9M4Z1NCYSDM	
What fish species do you study at the NEFSC 	I do not know what fish species I study at the NEFSC 	A2RHBR7XZGUI1C
How are supporting documents -LRB- transcripts and teacher recommendations -RRB- submitted as part of my Coalition Application 	I am not able to tell you how supporting documents are submitted as part of your Coalition Application 	AT7ADQKXKXEWY
Can Grandparents claim grandchildren 	I do not know if Grandparents can claim grandchildren 	A3NZLRU95OULXB
What is OnStar ® 	I do not know what OnStar ® is 	A16VTK6KZ1U69H
What steps can an employer take to reduce the risk of exposure of the Zika virus in the workplace 	I do not know what steps an employer can take to reduce risks 	A325WS381BHOHH
If I buy a Guided Tour for the Vatican Gardens , is it possible to see the Vatican Museums with the same ticket 	I do not know if you buy a guided tour for the Vatican Gardens , is it possible to see the Vatican Museums with the same ticket 	A3SS1F4F3JE7CU
Can I pay visa issuance fees with a credit card or a check 	I do not know if visa issuance fees can be paid for with a credit card or check 	A234VIHHUHPZG5
I specifically informed the waiter of my peanut allergy , but this entree includes visible peanuts in the sauce and I would like to return it 	I am not able to return it	3XD2A6FGFNM712T9PK70MKKJWMS9SV
After I learn to dance , will I still have to return to learn the newest steps 	I do not know if you will have to return to learn the newest steps after you learn to dance 	A1J0GU26323WVA
How long does the sign up process take 	I do not know how long the sign up process takes 	A8F4B0854KTXO	
Can I get some extra padding for this new shipment 	I am not able to provide extra padding for this shipment 	A1D9EH4NAAP40N
How much is my deductible 	I do not know how much your deductible is 	A9LX66EQWDRQ5	
Can you assist with a new order 	I am not able to assist with a new order 	A1GAARR4GOOZCO	
Can my children visit the museum with a family caregiver 	I do not know if your children can visit the museum with a family caregiver 	A2I4VNAS21FXCE
Can you adjust some things made on my order 	I am not able to adjust some things made on your oder 	ASFR82SJYMGNU
I would like some things removed from the order I just made 	I am not able to remove some things from the order you just made	A23CTGXNDDW5LC
Are service animals allowed at the Zoo 	I do not know if service animals are allowed at the zoo 	A13GUTDMGGZZDL
I 've been locked out of my account , what now 	I am not able to help you unlock your account 	A1YKWG46AWMPUX	
Can I do work experience at the zoo 	I am not able to tell you if you can do work experience at the zoo 	A2UBEPT605E8T2
How long is it until my subscription expires 	I do not know when your subscription expires 	A39MLQY9HOG1S6
Does the monthly tuition fee remain the same each month 	I do not know if the monthly tuition fee remains the same each month 	A2K9PB0U45O0MU
What 's the charge for overnight shipping 	I do not know the charge for shipping overnight 	A2PKDWREQV1JTR
Where can I find a detailed list of the nutritional information about each of the components of the meals on your delivery menu 	I do not know where to find a detailed list	3MVY4USGB6F0C3MCTEDDZDJMFCESIW
What are the Federal and State excise taxes rates for spirits , wine and beer 	I do not know what the Federal and State excise tax rates are for spirits , wine and beer 	A1XNCA1SVTT15B
Should I wear shoes 	I do not know know if you should wear shoes 	A2K9PB0U45O0MU
Who in Personnel should I contact about my appointment 	I do not know who you should talk to about your appointment 	A2K9PB0U45O0MU
How can I lower my monthly payments 	I do not know how to lower your monthly payments 	A260AFDCSXBQOH
How can I recycle used consumables 	I do not know how you can recycle used consumables 	A13GUTDMGGZZDL
Can I take a bus to the Hospital 	I do not know if you can take a bus to the Hospital 	A3RD486RQUI2XV
Who are the teachers 	I do not know who the teachers are 	A2UBEPT605E8T2
How can I avoid being attacked by a shark 	I do not know how you can avoid being attacked by a shark 	A2K2MFQMN31DZ
Are there restrictions on what sort of items I can bring into the Maritime Research Center 	I do not know if there are restrictions on what sort of items you can bring into the Maritime Research Center 	A2HKTM4Z8652
I saw you released a new model , how is it different from the old version 	I do not know how the new model is different from the old version 	AE9M4Z1NCYSDM	
What is the Crocker Art Museum Association 	I do not know what the Crocker Art Museum Association is 	A3U6CLX7HD0SMF
Can you tell me what ingredients in this product can set off an allergic reaction 	I do not know what ingredients in this product can set off an allergic reaction 	A8F4B0854KTXO	
Do you mind if I eat a competitors product in your store as long as I buy some of your product too so I can compare them 	I do not know if you can eat a competitor 's product in our store as long as you buy some of our product too to compare them 	A3B1H161LQLAYP	
I seem to be missing one item from my order that I placed last week , how do I get this mistake corrected 	I am not able to correct this order mistake for you 	307FVKVSYR7KLY35KMDYALD7NG174A
I will not be home for delivery . Can you re-route the package to a different address 	I do not know if we can re-route the package to a different address 	AD9O852KPYLHY	
I received towels I ordered . They were thinner than I thought . Can you recommend different brands 	I am not able to recommend different brands 	3FCO4VKOZ452D00Y9SPBJ7PY05V7EG
My old passport has already expired . My visa to travel to the United States is still valid but in my expired passport . Do I need to apply for a new visa with my new passport 	I do not know if you will need to apply for a new visa with your new passport 	ALDKJ42AAASLI
Will the store be open on Easter 	I do not know if the store will be open on Easter 	A3GNQDFPZALU92	
I 'd like to make sure this package arrives at a specific time , can you help me out here 	I am not able to help you 	3VEI3XUCZRPGSA93RK3SI0F2FOQPRH
Do provisions of the federal tax law such as section 66 -LRB- treatment of community income -RRB- and section 469 -LRB- i -RRB- -LRB- 5 -RRB- -LRB- $ 25,000 offset for passive activity losses for rental real estate activities -RRB- that apply to married taxpayers apply to registered domestic partners 	I do not know if provisions of the federal tax law such as section 66 -LRB- treatment of community income -RRB- and section 469 -LRB- i -RRB- -LRB- 5 -RRB- -LRB- $ 25,000 offset for passive activity losses for rental real estate activities -RRB- that apply to married taxpayers apply to registered domestic partners 	AJ7E01X4TAGHL
I lost the warranty for my item but it broke within two weeks , which would have been covered under the warranty . Can I do anything to verify this warranty and receive a new item 	I do not know if you can do anything to verify the warranty 	36BTXXLZ2V0U3HNKT0B4F247OSV4R6
How many employees are in the National Park Service 	I do not know how many employees are in the National Park Service 	A16VTK6KZ1U69H
How can I be involved with the Simeone Museum	I do not know how you can be involved with the Simeone Museum 	A3G2FBKYCRD5Q8
What levels/phases do you teach 	I do not know what levels and phrases we teach 	A9LX66EQWDRQ5
What is the balance in my account 	I do not know the balance in your account 	A8F4B0854KTXO	
What type of service do you do to the cars before selling them 	I do not know what type of service we do to the cars before selling them 	A2HKTM4Z8652
How does a group plan its visit 	I do not know How a group plans its visit	ATQD23E8ESFSI
How can I get to The Field Museum by public transport 	I do not know how you can get to The Field Museum by public transport 	A7SXWHGK8B40R
How long does it take to go through the Museum 	I do not know how long it takes to go through the Museum 	A1YUEWAWRZ590A
Shipping in 2 days is guaranteed but does that include delivery on a weekend day 	I do not know if that includes delivery on a weekend day 	A31A4YKVSOYRVS	
Can I use multiple coupons 	I do not know if you can use multiple coupons 	A31A4YKVSOYRVS	
I placed an order 2 weeks ago and I have n't received it yet , could you please check it	I am not able to check the order 	34D9ZRXCYRML6L3EHQL0IFV3249SAS
How can I learn about import or export licensing 	I do not know how you can learn about import or export licensing 	A7SXWHGK8B40R
Is it possible to put my subscription on hold for a few months 	I am not able to put your subscription on hold 	A2EAJXBORHT44T	
Can you help me find a suitable carseat 	I am not able to help you find a suitable carseat 	A9LX66EQWDRQ5	
What Time is Check-In / Check-Out 	I do not know what time check-in/check-out is 	AZLZA0Q87TJZO
Why is admission being increased 	I am not able to tell you why admission is being increased ,	A355BVFIOODRH2
Can I modify the source code 	I do not know if you can modify the source code 	APC99TPURUHR8
I want to reschedule my vacation ; there was a recent death in the family . I know I paid for the insurance plan , so what happens now 	I do not know what happens now 	3FDWKV9VCNU2NZ473Y65678RHIJUMU
What happens after I submit my application for a position 	I do not know what happens after you submit your application for a position 	A2K2MFQMN31DZ
How do elected officials and public access officers certify they have completed the training 	I do not know how elected officials and public access officers can certify that they have completed the training 	AT7ADQKXKXEWY
Why am I missing some search filters 	I do not know why you are missing some search filters 	A7SXWHGK8B40R
Is there a cash point at the Zoo 	I do not know if there is a cash point at the Zoo 	A3MFFF0TPDZQZS
Do I have to give an employee a hearing before I dismiss an employee on performance or misconduct grounds	I do not know if you have to give them a hearing 	A13GUTDMGGZZDL
I ca n't get the cord out of the back of the toaster , is this supposed to be this short 	I do not know if the cord is supposed to be short 	3WRBLBQ2GR0MF3W5UOUQ4V0N5740GQ
What about a version of that but with a lot more inside jokes and less helpfulness 	I do not know about a version with more inside jokes and less helpfulness 	ARKAJ6PL85CME
How much are tuition fees at French universities 	I do not know how much tuition fees at French universities are 	A3RD486RQUI2XV
Who do I contact if I need help 	I do not know who you need to contact if you need help 	A2K9PB0U45O0MU
Can I bring my pet 	I do not know if you can bring your pet 	A2K9PB0U45O0MU
Is the salary level threshold for determining exempt status under the Fair Labor Standards Act based on salary and the cost of benefits 	I do not know if the salary level threshold for determining exempt status under the Fair Labor standards act is based on salary and the cost of benefits 	A7SXWHGK8B40R
How and when is my vacation accrual calculated 	I do not know how and when your vacation accrual is calculated 	AHJYLSDFBLEWM
What other similar products do you offer 	I am not able to provide similar products that we offer 	AYJGJAIY0EXW
Why your forms are so long 	I do not know why our forms are so long 	APC99TPURUHR8
Is SMoCA open on holidays 	I do not know if they are open on holidays 	A13GUTDMGGZZDL
This plane ticket is way too expensive for me , can I exchange it for something else more affordable 	I am not able to exchange your ticket for you 	3A9LA2FRWS68CPXRH61FY9ZZUE1XHG
How do I exchange an order I purchased online 	I do not know how you can exchange your order 	A3VV5FFG6GXE1S	
How long until my tracking number is activated to be viewed 	I do not know how long until your tracking number is activated to be viewed 	A1JBSFXMMRGSQD
What if I have a problem with my spot or positioning 	I am not able to help you with spot or positioning problems 	A1NF93LWL8ABHH
I got home from your store and realized that my wallet was missing , is it there 	I do not know if your wallet is there at the store after you got home 	A1GAARR4GOOZCO	
How much to upgrade my services 	I do not know how much it is to upgrade your services 	A31A4YKVSOYRVS	
Why am I being prompted to change or verify the name that appears on my MileagePlus account 	I do not know why you are being prompted to change or verify the name that appears on your MileagePlus account 	A3G2FBKYCRD5Q8
If it is wet , is there anywhere to eat our packed lunches 	I do not know if there is a place to eat your packed lunches 	A2NI2HSU84PHJW
Do you offer digital gift cards that I can email to someone 	I do not know if we offer digital gift cards that you can email to someone	A23CTGXNDDW5LC	
Do I need a visa to study in France 	I do not know if you need a visa to study in France 	A2TP3K1THK6XRB
What is the Railway Labor Act -LRB- RLA -RRB- 	I do not know what the Railway Labor Act is 	A2EJ7U3TZAKROG
Can my child makeup a missed class 	I do not know if your child can makeup a missed class 	A3THR2UWGQNVX4
When does my membership begin 	I do not know when your membership begins 	A3RD486RQUI2XV
Did my purchase go through	I do not know if your purchase went through 	A2VIKCIM9TZL22
Do your vehicles carry a Factory Warranty 	I do not know if the vehicles carry a Factory Warranty 	A2NI2HSU84PHJW
Can I bring food & drinks to SMoCA 	I do not know if you can bring food & drinks to SMoCA 	A3G2FBKYCRD5Q8
Can you help me get this product faster 	I am not able to help you get this product faster 	A185P3B2MC2K83
What is the cheapest cruise package to Alaska 	I do not know the cheapest cruise package to Alaska 	A1YKWG46AWMPUX	
What services do you provide for home health 	I do not know what services we provide for home health	APF1EAZT104LQ
How many frequent flyer points do I need to cash in for a flight from Dallas to Detroit on the 18th 	I do not know how many frequent flyer points you need 	3TX9T2ZCB9TFEASVDNB0WXPXH2CZWF
Can I delay the shipment so it arrives closer to Christmas 	I do not know if you can delay the shipment so it arrives closer to Christmas 	A2IXBTOWQRCLPZ	
What programs are offered online 	I am not able to find what programs are offered online	A23OS0HQ12VVOR
Will your stores honor any competitor coupons 	I do not know if our stores will honor any competitor coupons 	A325WS381BHOHH	
Can you please help me reverse some of these over drafts charges 	I am not able to help you reverse the over drafts charges 	A260AFDCSXBQOH
How long do I have to return an item 	I do not know how long you have to return an item 	AD9O852KPYLHY	
Can I try this out before I buy it 	I do not know if you can try this out before you buy it	A23CTGXNDDW5LC
Do you have online services 	I do not know if we have online services	A23CTGXNDDW5LC
Are mobile devices permitted in the galleries 	I do not know if mobile devices are permitted in the galleries 	A2K9PB0U45O0MU
Do I need to come to the Zoo to become a member 	I do not know if you need to come to the Zoo to become a member 	AEB42Q2Z31GN
What if I need to cancel my party 	I do not know what to do if you need to cancel your party 	A9LX66EQWDRQ5
Where is Georgia Aquarium 	I do not know where Georgia Aquarium is 	A3B2YRXL26RPVH
How long will my item be on backorder 	I do not know how long your item will be on backorder 	A1J0GU26323WVA	
Are there any Yellowstone regulations I need to know about 	I am not able to tell you if there are any Yellowstone regulations you need to know about	APF1EAZT104LQ
I 'm trying to figure out when my order will be shipped 	I do not know when your order will be shipped 	ARCNENCVA0STW	
What is Latin dancing 	I do not know what Latin dancing is 	A1JBSFXMMRGSQD
What are the phone hours 	I do not know what the phone hours are 	A13GUTDMGGZZDL
How do I set usage alerts for minutes , messaging or data on my device 	I do not know how to set usage alerts for minutes , messaging , or data on your device 	ARKAJ6PL85CME
I was interested in investing in your business but do n't know who to talk to . Can you connect me with the proper agent 	I am not able to help connect you 	3PZDSVZ3J599OJVS0TUN6IZXNV64NI
Is internet access available for visitors in the Museum 	I do not know if internet access is available for visitors in the Museum 	A3B2YRXL26RPVH
Could you check if your company provide discount for large quantity purchase on a whole scale level	I am not able to check if our company provides discount for large quantity purchases on a whole scale level 	AMW07CJC3OJIB
How do I check out 	I do not know how you check out	A23CTGXNDDW5LC
How long do I have to wait for a delivery 	I do not know how long you have to wait for a delivery 	A185P3B2MC2K83
Northwestern accepts both the Coalition and Common Applications -- is there a preference 	I do not know if there is a preference between them 	A2NI2HSU84PHJW
Why is it necessary in Workday for a full-time employee to enter their time worked in a day in separate blocks 	I do not know why it 's necessary to enter it in separate blocks 	A13GUTDMGGZZDL
My account is locked , how do I get back in 	I do not know how you get back in if your account is locked 	A2HKTM4Z8652
Are there any special exhibits 	I do not know if there are any special exhibits 	A2VIKCIM9TZL22
May I book a private event at the museum 	I do not know if you can book a private event at the museum 	A2115OWJ0CKOB3
I just placed my order . Can I add another item to it	I do not know if you can add another item to an existing order 	A2D0IIX70FDQIW
Do you offer supplemental insurance 	I do not know if we offer supplemental insurance 	A31A4YKVSOYRVS	
Why does the train go backward and forward 	I do not know why the train goes backwards and forwards 	A1XNCA1SVTT15B
I was just accepted as a new hire at a company and need to register . Can you guide me through the process 	I am not able to guide you through the process of registering as a new hire at a company 	3J6BHNX0U9KU2LKVLLH3DZOTKHVKNN
I am very upset with the service I received , what can you do about it 	I am not able to help you with the service you received 	3JMNNNO3B1WP8ZPJOG2M9MFQWTE2WB
Can I transfer my assets to avoid the Estate Recovery Program 	I do not know if you can transfer your assets to avoid the Estate Recovery Program 	A1JBSFXMMRGSQD
Is it possible to reenter the museums 	I do not know if it is possible to reenter the museums 	A1JBSFXMMRGSQD
What is this 	I do not know what this is 	A3I9FTHSULHPYS
I need to file a claim 	I am not able to file a claim 	AD9O852KPYLHY	
May I have permission to link to your websites 	I am not able to give you permission to link to our websites 	A2VIKCIM9TZL22
Can you tell me the next time you 'll be receiving this item 	I do not know the next time I am receiving this item	A1ENE99INLYD1G
How can I provide feedback on my experience at MPSH 	I do not know how you can provide feedback on your experience at MPSH 	A3U0VQ420HIMQ0
Are the animals at your aquarium humanely treated 	I do not know if the animals at our aquarium are humanely treated 	A2EAJXBORHT44T	
I submitted a request for the deletion of my domain , and the page is still visible , why 	I am not able to tell you why the page is still visible after submitting a request for the deletion of your domain 	AU3WB2DD4QJ4B
Can a purchase a monthly pass for the train 	I do not know if you can purchase a monthly pass for the train 	A31A4YKVSOYRVS	
Is there an extra fee to use my card outside the country 	I do not know if there is an extra fee to use your card outside the country 	A9LX66EQWDRQ5	
May overtime be averaged out over two or more weeks 	I do not know if overtime can be averaged over two or more weeks 	A2NI2HSU84PHJW
My bank account has been charged twice for my monthly subscription , can you help me resolve this 	I am not able to help you resolve this 	A8F4B0854KTXO	
How can I make a gift to Harvard University 	I do not know how you can make a gift to Harvard University 	A3R71HP45TBQ7O
Please remove all of my billing information from my account 	I am not able to remove all of your billing information from your account 	A1YKWG46AWMPUX	
Hi , i need help accessing my online account with you , can you help me 	I am not able to help access your online account with us 	ASFR82SJYMGNU
How often are the machines disinfected at your gym ? I do not want to get sick going to gym 	I do not know how often the machines are disinfected at our gym 	3N3WJQXELSI9X5DKK2VK0BYAYMA2LI
Is an employer required to file Section 6055 or Section 6056 information returns electronically 	I do not know if an employer is required to file Section 6055 or Section 6056 information returns electronically	A1GNG0J27JYSUB
I have a busy schedule , do I have to register for classes 	I do not know if you have to register for classes 	A3LA5P3N3KI8U7
I am a beginner , will I still be able to perform at shows 	I do not know if as a beginner you will be able to perform at shows 	A3NZLRU95OULXB
My item is broken , is it covered under warantee 	I do not know if the broken item is covered under warantee 	A31A4YKVSOYRVS	
Are there any tickets still available for the concert 	I do not know if any tickets are still available for the concert 	AE9M4Z1NCYSDM	
With Roma Pass 72 Hours do the free entries necessarily have to be the first two admissions at museums and/or sites 	I do not know if with Roma Pass 72 Hours if the free entries necessarily have to be the first two admissions at museums and/or sites 	A2UBEPT605E8T2
Are all employees entitled to earn leave 	I do not know if all employees are entitled to earn leave 	A2EJ7U3TZAKROG
How can I get to the Museum on public transportation 	I do not know how you can get to the Museum on public transportation 	A2K9PB0U45O0MU
My package was supposed to arrive yesterday . It has n't . Can you please check on it 	I am not able to check on your package 	A31A4YKVSOYRVS	
My university required each incoming freshman to come to school with their own computer . Is there any way to deduct the cost of the computer from my tax liability 	I do not know if there is anyway to deduct the cost of the computer from your tax liability 	A3SS1F4F3JE7CU
Can you tell my why my shipment was delayed 	I am not able to tell you why your shipment was delayed 	A260AFDCSXBQOH
How much does it cost to perform at ZOO Venues 	I do not know the cost to perform at Zoo Venues 	A234VIHHUHPZG5
Is there a suggested route for visitors 	I do not know if there is a suggested route for visitors 	A3G2FBKYCRD5Q8
Can I use my membership at other zoos and AQUARIUMS	I do not know if you can use your membership at other zoos and aquariums 	A1IPD4WBT3A5GG
Where can I find height requirements and restrictions for your rides and attractions 	I do not know the height requirements and restrictions for our rides and attractions 	A2NI2HSU84PHJW
I think my card has been stolen ; can you tell me what to do to protect against identity theft 	I am not able to tell you what to do to protect against identity theft 	A31A4YKVSOYRVS	
Is Chevrolet currently offering any incentives or Special Offers 	I do not know if Chevrolet is currently offering any incentives or Special Offers 	A1J0GU26323WVA
How long does an interview take 	I do not know how long the interview takes 	A7SXWHGK8B40R
I recently changed my package for my phone , internet , and cable and was told that the price drop would show on my next bill . I just received my most recent bill and am not showing any decrease in price for bundling these services . Can you find out why the price change was not reflected on this months bill 	I do not know why the price change was not reflected on this months bill 	39KMGHJ4RZ2P4ZLKGM5NJ3D7YQF00N
What equipment is needed to collect fossils 	I do not know what equipment is needed to collect fossils 	A3CL6GEDFNQGQY
How long can I stay out in the backcountry 	I do not know how long you can stay out in the backcountry 	A2VIKCIM9TZL22
What are the dining options at The Field Museum 	I do not know what the dining options are at The Field Museum 	AT7ADQKXKXEWY
Do any of these clothing items come in contact with peanut products 	I do not know if any of these clothing items come in contact with peanut products 	AD9O852KPYLHY	
Since I ordered more then one good will it all be in one package or will they be separated 	I do not know if your goods will be all in one package or separated 	A9LX66EQWDRQ5	
Is there an extra fee to withdraw cash with my credit card 	I do not know if there is an extra fee to withdraw cash with your credit card 	AHGM882UX7S4T	
Should I make a reservation for a tour	I do not know whether you should make a reservation 	A13GUTDMGGZZDL
What if I also have a child at Camp Joey 	I do not know what happens if you also have a child at Camp Joey 	A32Y2DA2CW8YWN
If I Have Previously Completed An Application , Will I Automatically Be Considered For Other Positions 	I am not able to know if you will be considered for other positions	APF1EAZT104LQ
If I were to upgrade my line , how much extra per month would it be 	I do not know how much extra per month it will be if you upgrade your line 	A1J0GU26323WVA	
If I 'm coming with a group , do I need to make a reservation 	I do not know if you need to make a reservation 	A7SXWHGK8B40R
I have received an error message stating my entry contained invalid characters . Which characters are valid 	I do not know which characters are valid 	A2NI2HSU84PHJW
What happened to the money 	I do not know what happened to the money 	A13JQTLPWXZD6L
How much does the Artmobile cost 	I do not know how much the Artmobile costs 	A3G2FBKYCRD5Q8
What is replacement planning 	I do not know replacement planning 	A2NI2HSU84PHJW
Is the current sale on your website 24 or 48 hours 	I do not know if the current sale on the website is 24 or 48 hours 	ASFR82SJYMGNU
How can I find out about discounts 	I am not able to provide you any information or sources about possible discounts 	A13JQTLPWXZD6L
Do you offer any sort of discounts for customers on their birthday 	I do not know if we offer any sort of discounts for customers on their birthday 	A112W2FKT6UT62
Can I add my company logo and customize Kin 	I do not know how you can add your company logo and customize Kin 	A3CL6GEDFNQGQY
Can I return something that was broken 	I do not know if you can return a broken item	APF1EAZT104LQ
How much recovery time is needed after the lasik eye surgery 	I do not know how much recovery time is needed after the lasik eye surgery 	A31A4YKVSOYRVS	
What type of individual is the program seeking to find 	I do not know what type of individual the program is seeking to find 	AZLZA0Q87TJZO
Can I rent a wheelchair or STROLLER	I do not know if you can rent a wheelchair or stroller 	A3RD486RQUI2XV
Can I speak to a district manager 	I am not able to let you speak with a district manager 	A1YKWG46AWMPUX	
What do we offer for infants and Toddlers	I do not know what is offered 	A2NI2HSU84PHJW
May I wear Heelys or in-line skates , or bring a skate board or bicycle on-site 	I do not know if you can wear Heelys or in-line skates or bring a skate board or bicycle on-site	ATQD23E8ESFSI
Can I apply the in store promotion online 	I do not know if you can apply the in store promotion online 	AJQGWGESKQT4Y
Is it free to visit the 9/11 Memorial 	I do not know if it is free to visit the 9/11 Memorial 	A2ZBJWQ9ZZHYYI
Can I split my order over two cards 	I am not able to split your order over two cards 	A31A4YKVSOYRVS	
How much soy does your meat contain 	I do not know how much soy our meat contains 	A9LX66EQWDRQ5	
How can I find an enrollment center 	I do not know where you can find the enrollment center 	A18RMWE4BKHG6R
I accidentally placed an order before getting all the items I wanted shipped in there , can I still add those to combine shipping 	I do not know if you can still add items to combine shipping on an order you accidentally placed 	A325WS381BHOHH	
Who owns the Museum	I do not know who owns the Museum 	A2VIKCIM9TZL22
What fees may apply to the HIPAA Electronic Funds Transfer -LRB- EFT -RRB- transaction 	I do not know what fees may apply to the HIPAA Electronic Funds Transfer -LRB- EFT -RRB- transaction 	AZLZA0Q87TJZO
How often will the opportunity be provided to convert / open election periods 	I do not know how often the opportunity is provided to convert open election periods 	A2NI2HSU84PHJW
Is Discover accepted 	I do not know if Discover is accepted 	A185P3B2MC2K83
Is it possible to leave the Museum and return that day 	I do not know if you can leave the Museum and return that day 	A1J0GU26323WVA
Up to what age do children stay free of charge 	I do not know up to what age children stay free of charge 	A2VIKCIM9TZL22
Do I get a discount for visiting as a group 	I do not know if you get a discount for visiting as a group 	A116N2LEI6O7HB
I 'm looking for a book of poetry . Can you help me 	I am not able to help you look for a book 	36818Z1KV35HM4IZRBKZA7NRAOB3AC
Do I have to offer the same benefits to all employees 	I do not know if you have to offer the same benefits to all employees 	A1JBSFXMMRGSQD
Do you hold any rooms back for telephone bookings 	I do not know if we hold any rooms back for telephone bookings 	A9LX66EQWDRQ5
Where can I go to see a physical therapist that my insurance provider will cover with my policy 	I do not know where you can find a physical therapist covered by your insurance 	31D0ZWOD0ARL5CJ28O2G89PK7CR0AE
Should I take my routine medications before surgery 	I do not know IF YOU SHOULD take YOUR routine medications before surgery	ATQD23E8ESFSI
How can I change the credit card that 's being used on my account 	I am not able to change the credit card used on your account 	AE9M4Z1NCYSDM	
My creditcard is not accepted , what can I do 	I do not know what you can do if your credit card is not accepted 	A2VIN0EE9BGPSH
Is there special knowledge required to use HeavenHR 	I do not know if there is special knowledge required to use HeavenHR 	A16VTK6KZ1U69H
How can I request a ticket donation from the Museum for our fundraiser 	I do not know if you can require a ticket donation from the museum for a fundraiser 	A2NI2HSU84PHJW
Is it necessary for my child to dance over their summer vacation in order to advance at a typical pace 	I do not know if it necessary for your child to dance over their summer vacation in order to advance at a typical pace 	A2K9PB0U45O0MU
I hold a French residence permit -LRB- carte de séjour -RRB- but have lost it . Do I need a visa 	I do not know if you need a visa 	A2NI2HSU84PHJW
I am going to Phoenix on December 20th and would like to know the cheapest rates available 	I do not know the cheapest rates available to go to Phoenix on December 20th 	3MXX6RQ9EVX9R475G87FA74SNA74PE
I 'm not sure why this is happening , but I ca n't order from your site as the checkout process does n't work	I am not able to help you with your ordering problem 	3OYHVNTV5TQCK6K7M0HGSOOYAR0KO2
Can I use united.com Club deposits to pay for my taxes and fees for an award ticket -LRB- mileage redemption -RRB- 	I do not know if you can use United.com Club deposits to pay for your taxes and fees for an award ticket 	A2NI2HSU84PHJW
Can i file a complaint thru you 	I am not able to file a complaint 	30EV7DWJTVNHF53KQJWDKWHIN6G6YV
Do you have any specials if I place an order today 	I do not know if we have any specials today 	A9LX66EQWDRQ5	
I bought a pair of jeans but they do n't fit quite right , can you alter them for me 	I am not able to alter your jeans 	3XABXM4AJ1XVAHVMSOCHROA7USOQ8X
Is there street parking 	I do not know if there is street parking 	A1AF392CLGHH0X
In the case of a model that supports different languages , how do I change the ClassWiz language setting 	I do not know how you change the ClassWiz language setting	A7SXWHGK8B40R
Where can I purchase this specific product besides online 	I do not know where you can purchase that specific product besides online	AYJGJAIY0EXW
How long does the permitting process take 	I do not know how long the permitting process takes 	A3CL6GEDFNQGQY
Can I donate my pet to the Zoo 	I do not know if you can donate your pet to the Zoo 	A3U0VQ420HIMQ0
What if I want to visit another zoo and I do not have my membership card	I do not know what you should do if you want to visit another zoo and do not have your membership card 	A2HKTM4Z8652
May I leave and come back in 	I do not know if you can leave and come back in 	A2K2MFQMN31DZ
Can you tell me what the new features of your new phone model are	I am not able to tell you what the new features of our new model are 	A260AFDCSXBQOH
When does the free trial end 	I do not know when the free trial ends 	A325WS381BHOHH	
When do I need to submit my claim form 	I do not know when you need to submit your claim form	ABWW1P7GZ4C0Z
What is the average shipping time for an order like mine 	I do not know the average shipping time 	AI4AO0O0WIJF7
What is the difference between all-wheel drive and four-wheel drive 	I do not know what the difference is between all-wheel and four-wheel drive 	A3G2FBKYCRD5Q8
Is it true that I can get all the vitamins/minerals I need from the food that I eat 	I do not know if you can get all the vitamins/minerals you need from the food that you eat 	A2EJ7U3TZAKROG
Where should we keep employee records 	I do not know where we should keep employee records 	A3NZLRU95OULXB
Will I be able to receive calls and text messages while browsing the Web with att.net 	I do not know if you 'll be able to receive calls and text messages 	A13GUTDMGGZZDL
Can I watch a game that I 'm not playing in 	I do not know if you can watch a game you 're not playing in 	A2L0QFWMJU0AXB
How do I put a rush on my claim 	I do not know how you can put a rush on your claim 	AD9O852KPYLHY	
Can you tell me how much credit I have available 	I am not able to tell you how much credit you have available 	A260AFDCSXBQOH
Can I get a star named after me and claim copyright to it 	I do not know if you can get a star named after you and claim copyright to it 	A1WRD2K9USCOAV
Could you help me find a prom dress for my daughter 	I am not able to help you find a prom dress for your daughter 	A3VV5FFG6GXE1S	
I recently ate at your establishment . I ordered the lobster and it made me very sick . Can you connect me with the correct person to address this 	I am not able to connect you with that person right now 	34F34TZU7WR32FPKHHJ7KWLIUX52JG
What 's my order number	I do not know what your order number is 	A9LX66EQWDRQ5	
Do you have a showroom 	I do not know if we have a showroom 	A3RD486RQUI2XV
Is it possible for me to collect a package at an earlier time instead of waiting for it to be delivered to me 	I do not know if you can collect the package at an earlier time 	3BFNCI9LYKIZ32K1K88F0GL19G573P
What is the most prominent religion of Mexicans 	I do not know the most prominent religion of Mexicans 	A8O98QNRG9SHV
When can I upgrade a device 	I am not able to tell you when you will be able to upgrade a device	A3NZLRU95OULXB
Do you have a list of the aircraft on display in the museum 	I do not know if there is a list of the aircraft on display in the museum 	A2NI2HSU84PHJW
Where is the closest location of an onsite store 	I do not know the closest location of an outside store	AYJGJAIY0EXW
What is the rating scale used at DePaul 	I do not know the rating scale used at DePaul 	A8O98QNRG9SHV
What are the best times to avoid crowds 	I do not know the best times to avoid crowds 	A2NI2HSU84PHJW
Does the Museum have a parking lot 	I do not know if the Museum has a parking lot 	A2VIKCIM9TZL22
What is the dress code 	I do not know what the dress code is 	A13GUTDMGGZZDL
Can I bring my car club 	I do not know if you can bring your car club 	A1X3SF2W1QQBY1
Can I request a summary of my purchases 	I am not able to provide a summary 	AADRVG2QVZH75	
Can I personally deliver the donation to the museum 	I do not know if you can personally deliver the donation to the museum 	A7SXWHGK8B40R
How do I open an account 	I do not know how to open an account 	A113OGTB578EF6	
I am receiving error messages trying to complete the order . What should I do 	I do not know what you should do 	A2NI2HSU84PHJW
What sorts of products should I use for cooking 	I do not know which products 	A1DWQO9X2ZQ35G
Why would you put egg shell in coffee 	I do not know why you would put egg shell in coffee 	A3SQIRU1XI54BR
I need to send in some information but it 's not going through on the site . What do I do 	I am not able to what you need to do to send in information 	3VEI3XUCZRPGSA93RK3SI0F2FOQPRH
Do I need to give a privacy notice to everyone who walks into my showroom 	I do not know if you need to give a privacy notice to everyone who walks in your showroom 	A1S0R9UMW0FWAZ
What types of training are available for my company 	I do not know what types of training are available for your company 	A3G2FBKYCRD5Q8
I did not get an email saying that I am potentially eligible and as a result , I can not access the continuing appointments menus in inspira to conduct the review . However I meet the requirements to be considered . How can I request access 	I do not know how you can request access 	ARKAJ6PL85CME
How much do you charge for newspaper delivery 	I do not know how much we charge for newspaper delivery 	A31A4YKVSOYRVS	
Is our Vision Care covered on the Extended Health Claim Form 	I do not know if your Vision Care is covered on the Extended Health Claim Form 	A3RD486RQUI2XV
What if I want to make changes to the E-TRAC that I 've already submitted 	I am not able to tell you how to make changes to the E-TRAC you submitted 	A1F46RJTOXQM4J
Where can I have a work of art cleaned or conserved 	I do not know where you can have a work of art cleaned or conserved 	A2K9PB0U45O0MU
My son almost blew his hands off when your toy he was playing with suddenly exploded . I need you to give me all pertinent corporate information . I am going to sue 	I do not know the pertinent corporate information	3JAOYN9IHLUH2JJEIW5PNZ9L4EJ33G
Why outsource human resources duties to a PEO 	I do not know if you can outsource human resource duties as a PEO 	A13GUTDMGGZZDL
I 'd like to own a See 's franchise . How do I get started 	I do not know how you get started	A23CTGXNDDW5LC
May an employer terminate a pension plan 	I do not know if an employer may terminate a pension plan 	AZLZA0Q87TJZO
How does it relieve me from too much workload 	I do not know how it relieves you from too much workload 	APC99TPURUHR8
Are your orders shipped via FedEx 	I do not know if our orders are shipped via FedEx 	ASFR82SJYMGNU
What is the proximity of the HRR to Hueco Tanks State Park 	I do not know the proximity of the HRR to Hueco Tanks State Park 	A7SXWHGK8B40R
I have previously worked for the Federal government , am I eligible to apply 	I do not know if you are eligible to apply 	A1BWNS27NA1JAP
My television service is out . Is this the correct number to call to find out if there is a service outage 	I do not know if this is the correct number to call 	3EFNPKWBMSGLLRKHZ9N6L1BE12Z30L
What happens if I lose something in the Zoo 	I do not know what happens if you lose something in the zoo 	A2NI2HSU84PHJW
Can I reserve a place for a tour or encounter without payment	I do not know if you can reserve a place for a tour or encounter without payment 	A2K9PB0U45O0MU
Help ! I have an unusual application and I do n't know what slide product to use	I do not know what slide product you should use 	A3I9FTHSULHPYS
How can I Increase the number of Amazon S3 buckets that I can provision 	I do not know how you can increase the number of Amazon S3 buckets that you can provide 	A2NI2HSU84PHJW
Are foreign documents need to be endorsed by a diplomatic or consular mission , and are they need to be translated 	I do not know whether foreign documents need to be endorsed by a diplomatic or consular mission , and I do not know if they need to be translated 	A2VIKCIM9TZL22
How do I apply for a job with the National Park Service 	I do not know how you can apply for a job with the National Park Service 	A3G2FBKYCRD5Q8
I received my iWatch order today . Can you help me configure the network settings on my iWatch 	I am not able to help you configure the network settings on your iWatch	3J5XXLQDHM31ESLX26BV6U14VYBV34
Do I only pay the registration fee once 	I do not know if you only pay the registration fee once	A23CTGXNDDW5LC
I need to rent a car to drive to Denver . What type of pricing do you have for an economy model one way 	I do not know the pricing for an economy model one way 	3UQVX1UPFS9W09OYV9912R6MVOZ027
How can I apply to Vanderbilt 	I do not know how you can apply to Vanderbilt	A23CTGXNDDW5LC
How can an employer prevent the nonrepayment of overpaid wages that may result if a new employee quits shortly after receiving a signing bonus and other benefits 	I am not able to tell you how an employer can prevent the non-repayment of overpaid wages that may result if a new employee quits shortly after receiving a signing bonus and other benefits 	AT7ADQKXKXEWY
I forgot to use the coupon code . Is there any way you can refund me the difference or cancel my order so I can reorder with the coupon 	I am not able to refund you , or cancel your order	APF1EAZT104LQ
I am due to retire on or after 1 January 2018 at age 60 or 62 . Under the ICSC compensation package , the mandatory age of retirement for all staff members on board as of 1 January 2018 will be 65 . Will I be eligible for the continuing appointment now that I will have 7 years remaining from the eligibility date until I turn 65 	I do not know if you are eligible for the continuing appointment now that you will have 7 years remaining from the eligibility date until you turn 65 	A3SS1F4F3JE7CU
Where do I go for my inspection 	I do not know where you go for your inspection 	A3U0VQ420HIMQ0
Can you please tell me how to return my package 	I am not able to tell you how to return your package	A23CTGXNDDW5LC	
I ca n't find the extension of the person I am trying to reach . Can you help me navigate your directory 	I am not able to assist you in navigating the directory 	31KSVEGZ34K6CJ6436HNAUNY8LTRWE
I 'm wondering if I 'm able to bundle Earthquake insurance since I currently receive life , car and home insurance with your company 	I do not know if you are able to bundle Earthquake insurance since you currently receive life , car and home insurance with our company 	36D1BWBEHNTT3NV5KEWZ0ODZYR02MK
I received a refund in a wallet and how do I transfer to the original form of payment which was my credit card	I do not know how you transfer to the original form of payment 	3R5OYNIC2C1T8PMVV98NIFGK39NPTU
Is your milk made with hormones 	I do not know if our milk is made with hormones 	A3VV5FFG6GXE1S	
What options are available 	I do not know what options are available 	AD9O852KPYLHY	
How much alcohol can each adult bring onboard 	I do not know how much alcohol each adult can bring onboard 	AD9O852KPYLHY	
Is there a giant panda at Zoo Berlin 	I do not know if there is a giant panda at Zoo Berlin 	AU3WB2DD4QJ4B
May I transfer my membership to someone else 	I do not know if you may transfer your membership to someone else 	A2EJ7U3TZAKROG
Am I qualified for a loan of my credit is average or I need to have someone to co-sign 	I do not know if you will qualify for the loan 	3IZVJEBJ6ACHKVDPM5YWY3QKT0K6ZM
Can you connect me to someone in billing 	I am not able to connect you to someone in billing 	ASFR82SJYMGNU
Are authority records available as linked data 	I do not know are authority records available as linked data 	A3SS1F4F3JE7CU
Can I arrange to have materials waiting for me when I get there 	I do not know if you can arrange to have materials wating for you 	A13GUTDMGGZZDL
How do I apply for a job at Mandalay Bay 	I do not know how you would apply for a job at Mandalay Bay 	A3RD486RQUI2XV
What can I do if I receive my packsage and it is damaged 	I do not know what you do if you receive a package and it is damaged 	AE9M4Z1NCYSDM	
Can you check in your records and find my purchase history 	I am not able to check our records to find your purchase history 	A31A4YKVSOYRVS	
I found a beautiful shirt but I was wondering if I could put in a request for a bigger size and different color 	I do not know if you can put in a request for a bigger size and different color for the shirt that you found 	A1GAARR4GOOZCO	
What are the office hours of operation 	I do not know what the office hours of operations are 	A3I9FTHSULHPYS
Is free return shipping offered 	I do not know if free return shipping is offered 	ASFR82SJYMGNU
How long will it take for me to move from Level 1 to the next level	I do not know HOW LONG IT WILL TAKE FOR YOU TO MOVE FROM LEVEL 1 TO THE NEXT LEVEL 	ABWW1P7GZ4C0Z
Could you indicate the status of my shipping order 	I am not able to indicate the status of your shipping order 	A31A4YKVSOYRVS	
As the owner of a business , am I required to complete Form I-9 , Employment Eligibility Verification 	I do not know if you are required to complete Form I-9 , Employment Eligibility Verification 	A2EJ7U3TZAKROG
When can I arrive 	I do not know when you can arrive	A23CTGXNDDW5LC
Is there a page on your website where I can see the new merchandise 	I do not know if there is a page on our website where you can see the new merchandise 	A9LX66EQWDRQ5	
Is there a basic phone option on The Verizon Plan 	I do not know if there is a basic phone option on The Verizon Plan 	A3CL6GEDFNQGQY
How do I join or renew my membership 	I do not know how you join or renew your membership 	A3U6CLX7HD0SMF
Do you guys offer repair services for items 	I do not know if we offer repair services for items	A23CTGXNDDW5LC
How long does it take for a backordered item to ship 	I do not know how long it takes for a backordered item to ship 	A3GNQDFPZALU92	
Are there any obligations from the organization 	I do not know if there are any obligations from the organization 	A27MJOV91GA8R3
I want to place an order and the website is down . Can you put the order in for me or do I have to wait for the website 	I am not able to put the order in for you 	3ZICQFRS31AJ85X0OAV7V1JFY4GZZ5
I 'd like to pick up my package exactly a week from now , can we make this adjustment now if possible 	I am not able to make this adjustment	3I7SHAD35MO0POSBQQDUWFU797M7M5
How do retailers handle sales of sets containing both exempt and taxable items 	I do not know how retailers handle sales of sets 	A3B2YRXL26RPVH
If my child applies for one theme school -LRB- Zoo , Blandford , and Center for Economicology -RRB- and does n't like it , can they transfer to another theme school 	I do not know if your child can transfer to another theme school 	A1HLG5NN2I16GN
Do you ship out orders the same day 	I do not know if we ship out orders the same day 	A2TKHXY755FAM
I placed an order online and selected the wrong size shirt , can you change that for me 	I am not able to change that for you 	A185P3B2MC2K83
There is a fraudulent charge on my bank statement . Can you please look into this 	I am not able to look into a fraudulent charge on your bank statement 	A325WS381BHOHH	
How many calories do I need to burn to lose a pound of weight 	I do not know how many calories you need to burn to lose a pound of weight 	A1JBSFXMMRGSQD
How to read my invitation 	I do not know how to read your invitation 	A16NITTBMCSN0V
If I order a fruit basket , is it shipped chilled 	I do not know if a fruit basket is shipped chilled 	A3GNQDFPZALU92	
What do the abbreviations on my paycheck mean 	I do not know what the abbreviations on your paycheck mean	A23CTGXNDDW5LC
I want this parcel to be properly insured , but I 'm not sure how to go about it . Can you help me 	I am not able to set up insurance for the parcel 	3B623HUYJ4I7NXAZKS1MMOP8CG9S8O
Will you recruit or head hunt employees for us 	I do not know if we will recruit employees for you 	A2NI2HSU84PHJW
How can I verify the location of a package ? I ask because I still have not received my order	I do not know how you can verify the location of a package	3PIOQ99R7YE85HP7FZL5JMXRM8TUNU
What is the difference between these products 	I do not know the difference between these products 	A2C3I4DWGVPA1O
Where can I leave a review for your product 	I do not know where you can leave a review for the product 	AD9O852KPYLHY	
What is the admission fee for Students	I do not know the fee 	A1DWQO9X2ZQ35G
I want to upgrade my phone and I am not able to do it online at the moment , would you please help me	I am not able to help you upgrade your phone 	3YLPJ8OXX85E0D9W2ZHW4KQVP9FX4U
Can I request a quote 	I do not know if you can request a quote 	A31A4YKVSOYRVS	
What will I be seeing at the Vatican 	I do not know what you will be seeing at the Vatican 	AZLZA0Q87TJZO
Is the enamel surface scratch-resistant 	I do not know if the enamel surface is scratch-resistant 	A2HKTM4Z8652
What kind of art do you have at the MCA 	I do not know what kind of art you have at the MCA	APF1EAZT104LQ
What else is there to do in Santa 's Town 	I do not know what else there is to do in Santa 's Town 	A2115OWJ0CKOB3
Where and how do I vote 	I do not know where or how you vote 	AFS36YMNN8A2J
Can I become an American Friend of the Prado Museum if I 'm not from the USA 	I do not know if you can become an American Friend of the Prado Museum if you 're not from the USA 	A14M2EERU7E8KD
What are the office hours 	I do not know the hours 	A1DWQO9X2ZQ35G
How do I set up a candle fundraising campaign for my school 	I do not know how you set up a candle fundraising campaign for your school	A23CTGXNDDW5LC	
Why have n't I received my tracking code for my package 	I do not know why you have not received your tracking code 	AD9O852KPYLHY	
Where do I call for information on health screenings 	I do not know where you call for information on health screenings 	A7SXWHGK8B40R
May I take photographs of the art 	I do not know if you may take photographs of the art 	A16VTK6KZ1U69H
Are there any car parking charges 	I do not know if there are there any car parking charges 	A3RD486RQUI2XV
How many beds does Children 's Hospital have 	I do not know how many beds are at the Children 's Hospital 	A3CL6GEDFNQGQY
I would like to change my mobile phone plan . How much more a month will it be for an unlimited plan 	I do not know how much it would be to change your plan 	389A2A304OA9YRG0S2Y7E4F87FC0CG
What care services will be reflected on the new UVA Health System statement 	I do not know what care services will be reflected on the new UVA Health System statement 	A2HKTM4Z8652
Can pupils under 11 years old also follow an educational programme 	I do not know if pupils under eleven years old can follow an educational programe 	A3SS1F4F3JE7CU
Who can I speak with about donating items or animals to the Museum 	I do not know who you can speak with about donating items or animals to the Museum 	A3MBQX8F0IZO7S
Where can I purchase genuine Kia parts and accessories 	I do not know where you can purchase genuine Kia parts and accessories	A23CTGXNDDW5LC
How can I view My CDW Advantage price while I shop 	I do not know how you could view your My CDW Advantage price while you shop 	A2VIKCIM9TZL22
What is dessert like in Guatemala	I do not know what dessert is like in Guatemala 	APC99TPURUHR8
Is it true that tickets for The Polar Express ™ sell quickly 	I do not know if tickets for THe Polar Express ™ sell quickly 	A3NZLRU95OULXB
Do you have Military discounts available 	I do not know if we have Military discounts available 	A3U0VQ420HIMQ0
How much will taxes cost on my order 	I do not know how much taxes will cost on your order 	A185P3B2MC2K83
What payment structure did Oregon choose for eligible hospitals 	I do not know the payment structure Oregon chose for eligible hospitals 	A2K9PB0U45O0MU
Are there bike racks 	I do not know whether there are bike racks 	A1IPD4WBT3A5GG
Can one Nut be used by another account after delete 	I am not able to tell you if one Nut can be used by another account after being deleted 	A1JBSFXMMRGSQD
Are your clothing items true to size 	I do not know if our clothing items are true to size	A23CTGXNDDW5LC
Do we need to track telecommuting requests or send copies of the agreements to Human Resources 	I do not know if you need to track telecommuting requests or send copies of the agreements to Human Resources 	A1199EKUWHAKUQ
How many people does my membership admit per day 	I do not know how many people your membership admits per day	A23CTGXNDDW5LC
Can you help me change the pin code to my account so I can access it 	I am not able to help you change the pin code to your account	A23CTGXNDDW5LC
What do I need to get started 	I do not know what you need to get started	A23CTGXNDDW5LC
Who can I talk to about a lost package 	I do not know who you can talk to about a lost package 	A185P3B2MC2K83
What data speeds can I expect from my 4G LTE device while traveling outside the US 	I do not know what data speeds you can expect from your 4G LTE device while traveling outside the US 	A11TABPKSVOOFT
I am a graduate student receiving health insurance from the university but my address has changed and I can not change it through the insurance provider , can you help me make this change 	I am not able to help you make this change	3D1UCPY6GG133GPKUD0LEGHWK0B388
Where can I get copies -LRB- reproductions -RRB- of the Charters of Freedom 	I do not know where you can get copies -LRB- or reproductions -RRB- of the Charters of Freedom 	A2223XYV804AY7
Can I send my order to multiple recipients 	I do not know if you are able to send your order to multiple recipients 	A1JBSFXMMRGSQD
Can you help me set parental controls 	I am not able to help you set parental controls 	A3U6CLX7HD0SMF	
What kind of the payment methods for domestic flight tickets can I use 	I do not know what payment methods can be used for domestic flight tickets 	A234VIHHUHPZG5
Are agents available after 5 pm 	I do not know if agents are available after 5 pm 	A1OPGPTQJ48XOY	
Are your cosmetics tested on animals 	I do not know if our cosmetics are tested on animals 	A3GNQDFPZALU92	
Can you gift wrap my item 	I am not able to gift wrap your item 	A2YQAE441JMA7V	
What time does your customer service line close in the evening 	I do not know what time our customer service line closes in the evening 	A31A4YKVSOYRVS	
How does an employer classify an employee who performs two or more distinct types of jobs 	I do not know how an employer classifies an employee who performs two or more distinct types of jobs 	AZLZA0Q87TJZO
If service starts in the middle of a billing period is it pro rated 	I do not know if service starts in the middle of the month , if the billing period is prorated 	A39MLQY9HOG1S6
Please tell me when my package is expected to arrive 	I am not able to tell you when your package is expected to arrive 	A8F4B0854KTXO	
I need to set up auto pay 	I am not able to set up auto play 	A113OGTB578EF6	
Do you have locker rooms and showers 	I do not know if we have locker rooms or showers 	A2K9PB0U45O0MU
Can I pay with a Visa card 	I do not know if you can pay with a Visa card 	A1GAARR4GOOZCO	
How strong is the scientific evidence that Earth is warming and that humans are the main cause 	I do not know how strong the scientific evidence is that Earth is warming and that humans are the main cause 	A7SXWHGK8B40R
Do all oceans have tsunamis 	I do not know if all oceans have tsunamis 	A11TABPKSVOOFT
What if I have a question 	I do not know what to do if you have a question 	APC99TPURUHR8
Does an employer have a right to search an employee 's locker or desk 	I do not know if an employer has a right to search an employee 's locker or desk 	A1J0GU26323WVA
Can I change the cycle date on my account 	I do not know if you can change the cycle date on your account 	A325WS381BHOHH	
Is training included 	I do not know if training is included 	AQ9Y6WD8O72ZC
Ok , so how do I join 	I do not know how you can join 	APC99TPURUHR8
Can I make a payment 	I do not know if you can make a payment 	A3GNQDFPZALU92	
I need to track my package	I am not able to track your package 	A1JBSFXMMRGSQD
Can I have a free upgrade 	I do not know if you can get a free upgrade 	AE9M4Z1NCYSDM	
What if my tree does n't seem to be absorbing water in the stand 	I do not know why your tree does n't absorb water in the stand 	ALDKJ42AAASLI
I found an injured baby bird or mammal ; what should I do 	I do not know what you should do if you found an injured baby bird or mammal 	A2LQ9NP944M61Z
How do I choose a class that is right for me 	I do not know how you would choose a class that is right for you 	A2K2MFQMN31DZ
Where is an authorized service department for my new vehicle ? I need a tune up 	I do not know where an authorized service deparment is for your vehicle 	3TX9T2ZCB9TFEASVDNB0WXPXH2CZWF
Can you please check on my order for me 	I am not able to check on your order for you 	A31A4YKVSOYRVS	
Do you accept credit cards 	I do not know if we accept credit cards 	A13GUTDMGGZZDL
If I am a member , but am not able to visit Bishop Museum , can my children come without me 	I do not know if your children can come without you 	A2NI2HSU84PHJW
How long are the group classes 	I do not know how long the group classes are 	A2HKTM4Z8652
My card -LRB- s -RRB- was lost/damaged/stolen . How can I replace my card 	I do not know how you can replace your card 	A13GUTDMGGZZDL
My toiled sometimes flush uncontrollably for like 10 minutes . Is there a DIY solution you can suggest 	I am not able to suggest a solution 	3GMLHYZ0LEP2HGTLM1UG02VYQSXUYK
What is the period of time within which the education award can be used 	I do not know the period of time within which the education award can be used 	A2VIKCIM9TZL22
I did not turn in my paper Form I-94 when I left the United States , what should I do 	I do not know what you should do if you did not turn in your paper Form I-94 when you left the United States 	AZLZA0Q87TJZO
Where can I go to sit in your chairs 	I do not know where you can go to sit in our chairs 	A3RD486RQUI2XV
Are we going to be touching live animals 	I do not know if you will be touching live animals 	A16NITTBMCSN0V
I need to order something for my company . Do you accept purchase orders and send invoices 	I do not know if we accept purchase orders 	3T5ZXGO9DEGAUDW91ECU487BT1VZQB
Can I request a donation from Mandalay Bay 	I do not know if you can request a donation 	A13GUTDMGGZZDL
Why is my payment being declined	I do not know why your payment was declined 	A1HQRT1UG6ERGL
Can I see showtimes for different dates and locations 	I am not able to tell you if you can see showtimes for different dates and locations	APF1EAZT104LQ
Do I have to register with your office to be protected 	I do not know if you need to register with our office to be protected	A1GNG0J27JYSUB
May a union employee demand to have a union representative present during an investigative interview 	I do not know if a union employee may demand to have a union representative present during an investigative interview 	AFS36YMNN8A2J
Can the HUBZone office expedite my application 	I do not know fi the HUBZone office can expedite your application 	A1J0GU26323WVA
I 'm unable to attend the deep sea fishing tour on June 11th , can I reschedule for the 15th 	I do not know if you can reschedule for the 15th	3G57RS03HHXVVGAZSFFDJM2DCWA52X
How do I check the status of an order online 	I do not know how you check the status of an order online 	A3RD486RQUI2XV
My tooth pain just got much worse . Can we reschedule my dental appointment to as early as possible 	I am not able to help you reschedule 	3UDTAB6HH6R70T9XGIOGCEE01U909Z
Why do you have a dress code 	I do not know why we have a dress code 	AF8KEA2127EAN
Is it too late to add 2 to my quanitity of goods being shipped 	I do not know if it is too late to add to the quantity of goods being shipped 	A3U6CLX7HD0SMF	
My question is n't answered here . Who can I contact 	I am not able to tell you who you can contact	APF1EAZT104LQ
Which international channels are available with this satellite service 	I do not know which international channels are available with this satellite service 	ARCNENCVA0STW	
What happens if I move and/or my address changed 	I do not know what happens if you move or your address changes 	A2NI2HSU84PHJW
Is photography permitted in the Museum 	I do not know if photography is permitted in the Museum	ATQD23E8ESFSI
Are there audio guides inside the museum 	I do not know if there are audio guides inside the museum 	A16VTK6KZ1U69H
How does the reciprocal program work 	I do not know how the reciprocal program works 	A3I9FTHSULHPYS
Are the porterhouses fresh	I do not know if the porterhouses are fresh 	A31A4YKVSOYRVS	
I want to know when I can expect my insurance to go into effect 	I do not know when you can expect your insurance to go into effect 	AE9M4Z1NCYSDM	
Will you bill my credit card automatically to renew or should I call 	I do not know if we will bill your credit card automatically to renew or if you should call 	ASFR82SJYMGNU
Will I receive a tracking number for my order 	I do not know if you will receive a tracking number for your order 	A9LX66EQWDRQ5
Do you offer payment plans for re-activation 	I do not know if we offer payment plans for re-activation 	AMW07CJC3OJIB
I am the PD/PI on an NIH grant , but I am not the responsible party for the clinical trial that the grant supports . If the trial is not in compliance with FDAAA or in adherence with the NIH Policy on the Dissemination of NIH-Funded Clinical Trial Information , may I register or submit results of the trial in ClinicalTrials.gov 	I do not know if you may register or submit results of the trail in ClinicalTrials.gov 	A7SXWHGK8B40R
Can I land my plane at the Museum	I do not know if you can land your plane at the museum 	A2K9PB0U45O0MU
I ca n't understand you very well , can we switch to french 	I am not able to switch to French 	A8F4B0854KTXO	
Do I have to pay for return shipping 	I do not know if you have to pay for return shipping 	A9LX66EQWDRQ5	
Where are you located on the Strip	I am not able to tell you where I am located on the strip 	A18RMWE4BKHG6R
What is your product return policy 	I do not know our product return policy 	A1YKWG46AWMPUX	
What can I do about a package I believe was stolen from me ? I 'd like some compensation	I do not know what you can do about a package you believe was stolen from you	3PIOQ99R7YE85HP7FZL5JMXRM8TUNU
What is vanillin , or artificial vanillin , and why is it used 	I do not know what vanillin is or why it is used 	A3RKYD8IUC5S0N
How do I upgrade my room 	I do not know how you can upgrade your room 	A2VIKCIM9TZL22
Can I see the pavilion stage and hear music from the Lawn Area	I do not know if you can see the pavilion stage and hear music from the lawn area 	ARKAJ6PL85CME
I 'm moving in two months , and I wanted to make sure that my mailed subscription goes to the right place . I wo n't have a US mailing address for one month , is there anything I can do to get my monthly order early 	I do not know if there is anything you can do to get your monthly order early	3YZ7A3YHR5LO0FRXMUUJA4FHAQ8S5M
What years are available for the content 	I do not know what years are available for the content 	A3R71HP45TBQ7O
I lost my id cards , can i go online to get a new one , or do i have to wait for it in the mail 	I do not know if you can go online and get a new one 	3IJ95K7NDX4P0ZOCVUWOF7W0D0ENGN
Do you have places to eat , or can I bring my own food into the museum 	I do not know if we have places to eat , or if you can bring your own food into the museum 	A3I9FTHSULHPYS
I am interested in upgrading my membership to a higher level . How should I do this 	I do not know how you upgrade your membership to a higher level 	A3RD486RQUI2XV
How do I reset my current voicemail password 	I do not know how you reset your current voicemail password 	A2HKTM4Z8652
Is a stepparent eligible to be the caretaker for an applicant age 14-21 	I do not know if a stepparent is eligible to be the caretaker for an applicant age 14-21 	A1R1J3GL0YP7DJ
Can we use the shop without paying to get into the Zoo 	I do not know if you can use the shop without paying to get into the Zoo 	A1JBSFXMMRGSQD
If I forgot to order something this morning , can I still add the item to my order 	I do not know if you can still add an item to your order 	AD9O852KPYLHY	
How long does it take to prepare an order for 100 of these custom made signs 	I do not know how long it takes to prepare an order for 100 of these custom made signs 	A8F4B0854KTXO	
How much does a Wag ! dog walk cost 	I do not know how much a Wag ! dog walk costs 	A13GUTDMGGZZDL
I would like to purchase an online subscription but the site says my country 's region is n't available is there anything wrong 	I do not know if there is anything wrong 	3XUSYT70ITTJ3JMESYTIYAXQSFO0DG
How do you define a family member 	I do not know how you define a family member 	A3RD486RQUI2XV
Do you use props or shills 	I do not know which of these we use 	A16NITTBMCSN0V
Where are the toilets located 	I do not know where the toilets are located 	A2NI2HSU84PHJW
How do I apply my discount at checkout 	I do not know how to apply your discount at checkout 	A1SMUBAUJSL6P3
I know it 's sold out elsewhere , but do you carry any of these 	I do not know if we carry any of these	A23CTGXNDDW5LC
It 's been some time since I 've received my order , can you look into the location of the package 	I am not able to look into the location of the package 	3XH7ZM9YX2MV0NTWAV7VWAFNAK99R7
Why did n't the basket I order look exactly like the one in the picture : I am noticing a lot of different brands and products 	I do not know why the basket you ordered does n't look exactly like the one in the picture 	A1YKWG46AWMPUX	
Is Pacific a religious or church-related university 	I am not able to tell you if Pacific is a religious or church-related university 	A3RD486RQUI2XV
What holidays are observed at the University 	I do not know what holidays are observed at the University 	A27MJOV91GA8R3
What are your busiest days 	I do not know what our busiest days are 	APC99TPURUHR8
What is Retro Cinema 	I do not know what Retro Cinema is 	A14M2EERU7E8KD
If it is very cold will the animals still be out and about 	I do not know if the animals will still be out and about if it is very cold 	APC99TPURUHR8
What Is The Membership Renewal Process 	I do not know what the membership renewal process is	A1CMT9MVUO52VP
What if the beginner class is too hard 	I do not know if the beginner class is too hard	A23CTGXNDDW5LC
What will be my monthly payment 	I do not know what your monthly payment will be	A23CTGXNDDW5LC
Can I book an educational programme in another language 	I do not know if you can book an educational programme in another language 	A3CL6GEDFNQGQY
My package was supposed to be delivered yesterday , can you track it for me 	I am not able to track your package that was supposed to be delivered yesterday 	A3GNQDFPZALU92	
Can you help me reset my online password so that I can log into my account on your website 	I am not able to help you reset your online password so that you can log into your account on our website	30U1YOGZGAOJ4S6Q10C28G39N76SDU
What is my password 	I do not know what your password is 	A3U6CLX7HD0SMF
Will I need to provide a major credit card 	I do not know if you will need to provide a major credit card 	A3GNQDFPZALU92	
What is happening to the compelling reason time policy 	I do not know what is happening to the compelling reason time policy 	A2NI2HSU84PHJW
