"Why is the duration calculated when I apply for leave different to my hours of work "	"I do not know why the duration is calculated when you apply for leave different to your hours of work"	"WQUES"
"Where do I go to change my beneficiaries "	"I do not know where you go to change your beneficiaries"	"WQUES"
"What are the terms of my contract "	"I do not know what the terms of your contract are"	"WQUES"
"Does Zoo College provide me with standard college or university credits toward my degree "	"I do not know if Zoo College provide you with standard college or university credits toward your degree"	"DO_QUESTION"
"Can you help me take this to my car "	"I do not know if I can help you take this to your car"	"BE_HAVE_MD_QUESTION"
"Why can the system build such a profile , or what is the scientific foundation of it "	"I do not know why can the system build such a profile , or what is the scientific foundation of it"	"WSUBJ"
"Do you all have this dress in a size 6 "	"I do not know if I all have this dress in a size 6"	"DO_QUESTION"
"When is my start date "	"I do not know when your start date is"	"WQUES"
"Do you have any special offers on items this month "	"I do not know if I have any special offers on items this month"	"DO_QUESTION"
"I have a membership , but never used it online . What should I do "	"I do not know how to but never used it"	"IMPERATIVE"
"How do I order a card for my spouse "	"I do not know how you order a card for your spouse"	"WQUES"
"Can I still buy tickets online "	"I do not know if you can still buy tickets online"	"BE_HAVE_MD_QUESTION"
"I do n't see the Windows 8.1 or Windows 10 edition I 'm looking for . Where else should I check "	"I do not know where else you should check"	"WQUES"
"Did my card go through"	"I do not know if your card went through"	"DO_QUESTION"
"Are your prices the same in the store and online , or do you run different specials online "	"I do not know if my prices are the same in the store and online , or I run different specials online"	"BE_HAVE_MD_QUESTION"
"Why am I being charged extra for this "	"I do not know why you are being charged extra for this"	"WQUES"
"Do you sell floor mats "	"I do not know if I sell floor mats"	"DO_QUESTION"
"What are the benefits of learning Ballroom dancing "	"I do not know what the benefits of learning Ballroom dancing are"	"WQUES"
"I would like to buy a new laptop but it wo n't let me add it to my cart "	"I do not know how to handle 'I would like to buy a new laptop but it wo n't let me add it to my cart '"	"CANONICAL_IDK"
"I bought a couple of things right now , checked out , but realized I forgot a couple of things and am wondering if I can add them to my order "	"I do not know how to checked"	"IMPERATIVE"
"What hours is your store open "	"I do not know what hours is my store open"	"WQUES_SIMPLE"
"If , due to a disability , I am unable to travel to an IDNYC enrollment center , how can I apply for my IDNYC card "	"I do not know how you If , due to a disability , you are unable to travel to an IDNYC enrollment center , can apply for your IDNYC card"	"WQUES"
"What if I do not speak English "	"I do not know what you if not speak English"	"WQUES"
"I need to verify that you have my correct phone number "	"I do not know how to handle 'I need to verify that you have my correct phone number '"	"CANONICAL_IDK"
"Is photography permitted in the Anne Frank House "	"I do not know if photography is permitted in the Anne Frank House"	"BE_HAVE_MD_QUESTION"
"I want to screen the film in my home . Do I still need to buy a license "	"I do not know how to screen the film in your home ."	"IMPERATIVE"
"What do I do if my package gets lost "	"I do not know what you do if your package gets lost"	"WQUES"
"When must flexible retention periods be applied consistently across an agency or office "	"I do not know when flexible retention periods must be applied consistently across an agency or office"	"WQUES"
"When I am automatically upgraded , how do you assign my seat "	"I do not know when you are automatically upgraded , how I assign your seat"	"WQUES"
"Can you provide a breakdown of how many DACA EADs expire in 2017 , 2018 , and 2019 "	"I do not know if I can provide a breakdown of how many DACA EADs expire in 2017 , 2018 , and 2019"	"BE_HAVE_MD_QUESTION"
"Can I cancel or reschedule an appointment online "	"I do not know if you can cancel or reschedule an appointment online"	"BE_HAVE_MD_QUESTION"
"When I called last time to ask about loan options , I spoke to someone really helpful . If I give you her name , is there a way you can connect me to her again "	"I do not know when you called last time to ask about loan options"	"WQUES"
"Did John Wayne shoot any films in Lone Pine "	"I do not know if John Wayne shot any films in Lone Pine"	"DO_QUESTION"
"Can I purchase a Dorint voucher as a present "	"I do not know if you can purchase a Dorint voucher as a present"	"BE_HAVE_MD_QUESTION"
"Why was my order canceled"	"I do not know why your order was canceled"	"WQUES"
"Is there anything I should n't bring "	"I do not know if there is anything you should n't bring"	"BE_HAVE_MD_QUESTION"
"What does the Museum do to support teachers "	"I do not know what the Museum does to support teachers"	"WQUES"
"when on a project assignment , who is my employer "	"I do not know when on a project assignment , who is your employer"	"WQUES_SIMPLE"
"Is this a rain or shine event "	"I do not know if this is a rain or shine event"	"BE_HAVE_MD_QUESTION"
"Q : How long should I wait for the interview invitation after I summit my resume "	"I do not know how long you should wait for the interview invitation after you summit your resume"	"WQUES"
"Can we bring our own picnic to the zoo "	"I do not know if you can bring your own picnic to the zoo"	"BE_HAVE_MD_QUESTION"
"Is the boat handicap accessible "	"I do not know if the boat handicap is accessible"	"BE_HAVE_MD_QUESTION"
"I think I need to cancel an order I just made "	"I do not know how to handle 'I think I need to cancel an order I just made '"	"CANONICAL_IDK"
"Are my FMLA forms and informational posters out of date "	"I do not know if your are FMLA forms and informational posters out of date"	"BE_HAVE_MD_QUESTION"
"Does the Library of Congress provide Z39 .50 access to authority records "	"I do not know if the Library of Congress provides Z39 .50 access to authority records"	"DO_QUESTION"
"When is tuition do and how do I pay "	"I do not know when tuition is do and how do you pay"	"WQUES"
"Where can we find discount codes for the zoo "	"I do not know where you can find discount codes for the zoo"	"WQUES"
"I had an unpleasant experience with a customer service agent , who can I talk to about this "	"I do not know an unpleasant experience with a customer service agent , who can you talk to about this you had"	"WQUES"
"I forgot my answer to the challenge question , how do I access my account "	"I do not know how you access your account"	"WQUES"
"The price just came down 30 % on an item that I bought an hour ago , Can I get credited back some money "	"I do not know if you can get credited back some money"	"BE_HAVE_MD_QUESTION"
"What are the premium rates "	"I do not know what the premium rates are"	"WQUES"
"There 's no way I can make a payment tomorrow , can I have an easement until Friday "	"I do not know if you can have an easement until Friday"	"BE_HAVE_MD_QUESTION"
"Is govinfo 508 compliant "	"I do not know if govinfo 508 is compliant"	"BE_HAVE_MD_QUESTION"
"What is the Intel ® Developer Zone "	"I do not know what the Intel ® Developer Zone is"	"WQUES"
"What do I do if a class is full "	"I do not know what you do if a class is full"	"WQUES"
"What is my online account "	"I do not know what your online account is"	"WQUES"
"Are the asphalt seeps restricted to the pits in Hancock Park "	"I do not know if the asphalt are seeps restricted to the pits in Hancock Park"	"BE_HAVE_MD_QUESTION"
"Does the Zoo have a reciprocal agreements with other institutions "	"I do not know if the Zoo has a reciprocal agreements with other institutions"	"DO_QUESTION"
"Do I need to file a claim with my insurance "	"I do not know if you need to file a claim with your insurance"	"DO_QUESTION"
"Can I pay with two different cards "	"I do not know if you can pay with two different cards"	"BE_HAVE_MD_QUESTION"
"What expenses must be reimbursed "	"I do not know what expenses must be reimbursed"	"WQUES_SIMPLE"
"What are the museum 's admission fees to view the permanent collection "	"I do not know what the museum 's admission fees to view the permanent collection are"	"WQUES"
"How do I Book Group Reservations"	"I do not know how you Book Group Reservations"	"WQUES"
"I ordered a package from the website , what is the estimated date of arrival and is there a tracking number for the shipment "	"I do not know a package from the website , what is the estimated date of arrival and is there a tracking number for the shipment you ordered"	"WQUES"
"If I order 5000 of your units , can I get a bulk discount ? I am running a small business "	"I do not know if you can get a bulk discount"	"BE_HAVE_MD_QUESTION"
"When is my package going to arrive "	"I do not know when your package is going to arrive"	"WQUES"
"I was n't sure about this bit of paperwork and could use some help "	"I do not know how to handle 'I was n't sure about this bit of paperwork and could use some help '"	"CANONICAL_IDK"
"What 's next for Congress.gov "	"I do not know what 's next for Congress.gov"	"WSUBJ"
"What 's wrong with a jailbroken or rooted device "	"I do not know what 's wrong with a jailbroken or rooted device"	"WSUBJ"
"Are there hands-on activities that the students can participate in when we visit "	"I do not know if there hands-on activities that are the students can participate in when you visit"	"BE_HAVE_MD_QUESTION"
"Do you offer an extended service plan "	"I do not know if I offer an extended service plan"	"DO_QUESTION"
"When should I submit my documents for the I-20 Certificate of Eligibility "	"I do not know when you should submit your documents for the I-20 Certificate of Eligibility"	"WQUES"
"Is the museum handicapped accessible "	"I do not know if the museum is handicapped accessible"	"BE_HAVE_MD_QUESTION"
"How do I know which level of class to take "	"I do not know how you know which level of class to take"	"WQUES"
"If an HR manager makes a verbal promise to an employee that he or she would not be terminated , how does that affect the employment at-will status of that employee "	"I do not know how that affects the employment at-will status of that employee"	"WQUES"
"Which car park do you suggest for visitors to the Fashion Museum "	"I do not know which car park I suggest for visitors to the Fashion Museum"	"WQUES"
"What formats are available for community screenings "	"I do not know what formats are available for community screenings"	"WQUES_SIMPLE"
"Is it possible to have a green smoothie delivered to my house every other morning "	"I do not know if it is possible to have a green smoothie delivered to your house every other morning"	"BE_HAVE_MD_QUESTION"
"I would like to know what happened to my order problem in the resolution center "	"I do not know what happened to your order problem in the resolution center"	"WSUBJ"
"Why ca n't I use the 20 % code Spring56 on my order "	"I do not know why you ca n't use the 20 % code Spring56 on your order"	"WQUES"
"Can we bring our pet "	"I do not know if you can bring your pet"	"BE_HAVE_MD_QUESTION"
"Do you offer delivery of the pool table inside the house "	"I do not know if I offer delivery of the pool table inside the house"	"DO_QUESTION"
"Do you have a mailing list I can sign up for "	"I do not know if I have a mailing list you can sign up for"	"DO_QUESTION"
"How can I be assured animals are treated humanely "	"I do not know how you can be assured"	"WQUES"
"When will my shirt ship"	"I do not know when will your shirt ship"	"WQUES_SIMPLE"
"Do I need a reason to dismiss on notice"	"I do not know if you need a reason to dismiss on notice"	"DO_QUESTION"
"When should a job offer be withdrawn "	"I do not know when a job offer should be withdrawn"	"WQUES"
"My Cat Is Going Bald on Her Hind Legs . Should I Be Concerned "	"I do not know if you should Be Concerned"	"BE_HAVE_MD_QUESTION"
"Can I submit the paperwork online "	"I do not know if you can submit the paperwork online"	"BE_HAVE_MD_QUESTION"
"How do I request a background check "	"I do not know how you request a background check"	"WQUES"
"My product was delivered to my billing address instead of my shipping address "	"I do not know how to your product was delivered to your billing address instead of your shipping address"	"IMPERATIVE"
"How long will I be there "	"I do not know how long will you be there"	"WQUES_SIMPLE"
"What benefits am I entitled to at these museums "	"I do not know what benefits you are entitled to at these museums"	"WQUES"
"Am I allowed to bring my stroller or carrier into the theater "	"I do not know if you are allowed to bring your stroller or carrier into the theater"	"BE_HAVE_MD_QUESTION"
"Can I purchase Summer tickets in Winter , and vice versa "	"I do not know if you can purchase Summer tickets in Winter , and vice versa"	"BE_HAVE_MD_QUESTION"
"How do shellfish establish themselves on the sea bottom "	"I do not know how shellfish establish themselves on the sea bottom"	"WQUES_SIMPLE"
"I 'm filling out my address form , I have two different addresses , is there a place on the application to put in the other address "	"I do not know if there is a place on the application to put in the other address"	"BE_HAVE_MD_QUESTION"
"How can I stop my free trial "	"I do not know how you can stop your free trial"	"WQUES"
"Do you need a passport to cruise to Mexico "	"I do not know if I need a passport to cruise to Mexico"	"DO_QUESTION"
"How much dance training should a prospective student have prior to attending Point Park "	"I do not know how much dance training a prospective student should have prior to attending Point Park"	"WQUES"
"How long does it take for service to start "	"I do not know how long it takes for service to start"	"WQUES"
"May we bring in decorations "	"I do not know if you may bring in decorations"	"BE_HAVE_MD_QUESTION"
"How do I set up mailing so your mail goes to my home address instead of my po box "	"I do not know how you set up mailing so my mail goes to your home address instead of your po box"	"WQUES"
"What languages is the tour in "	"I do not know what languages the tour in is"	"WQUES"
"Does state tax treatment of cafeteria plan benefits match IRS rules "	"I do not know if state tax treatment of cafeteria plan benefits matches IRS rules"	"DO_QUESTION"
"Why am I not able to return these items "	"I do not know why am you not able to return these items"	"WQUES_SIMPLE"
"My truck windshield is cracked , i wanted to know if the car insurance covers that "	"I do not know how to handle 'My truck windshield is cracked , i wanted to know if the car insurance covers that '"	"CANONICAL_IDK"
"I would like a paper invoice sent to me with the package "	"I do not know how to handle 'I would like a paper invoice sent to me with the package '"	"CANONICAL_IDK"
"If a zoo is part of a bigger attraction -LRB- eg a theme park -RRB- does the inspection take account of / inspect any of the non-zoo part of the attraction "	"I do not know how to inspect any of the non-zoo part of the attraction"	"IMPERATIVE"
"What time is it in Guatemala"	"I do not know what time it is in Guatemala"	"WQUES"
"What are we looking for as verification of registration with Selective Service "	"I do not know what you are looking for as verification of registration with Selective Service"	"WQUES"
"What if I do n't have access to a printer or can not print the voucher "	"I do not know what you if n't have access to a printer or can not print the voucher"	"WQUES"
"I am interested in taking pictures at Philbrook , but the photographer is not professional . Do I still need to pay a fee "	"I do not know how to but the photographer is not"	"IMPERATIVE"
"One of my team has announced she is pregnant , what do I need to do "	"I do not know what you do need to do"	"WQUES"
"I think I may have been charged twice , how do I fix this "	"I do not know how you do fix this"	"WQUES"
"Will I need to provide my party 's guest and travel information during the purchase process"	"I do not know if you will need to provide your party 's guest and travel information during the purchase process"	"BE_HAVE_MD_QUESTION"
"I ca n't see my member discount in my shopping cart . What do I do "	"I do not know what you do"	"WQUES"
"Do you charge a monthly fee for checking accounts "	"I do not know if I charge a monthly fee for checking accounts"	"DO_QUESTION"
"Collapse What should I do if my package is delayed or late "	"I do not know Collapse What should you do if your package is delayed or late you should do if your package is delayed or late"	"WQUES"
"What events take place at the Museum and how do I book them "	"I do not know how you book them"	"WQUES"
"Can I check my account balance "	"I do not know if you can check your account balance"	"BE_HAVE_MD_QUESTION"
"I need to change my username and password "	"I do not know how to change your username and password"	"IMPERATIVE"
"What is Round Up for Conservation "	"I do not know what Round Up for Conservation is"	"WQUES"
"Would I be able to reserve my order "	"I do not know if you would be able to reserve your order"	"BE_HAVE_MD_QUESTION"
"Where is your studio , exactly "	"I do not know where my studio is , exactly"	"WQUES"
"Do you know of any hotels near the Zoo "	"I do not know if I know of any hotels near the Zoo"	"DO_QUESTION"
"What is the date and time of Brew at the Zoo "	"I do not know what the date and time of Brew at the Zoo is"	"WQUES"
"do you know when the next generation product will be available for this model , I am deciding if I should wait for the new line up or buy it now"	"I do not know if I know when the next generation product will be available for this model , you are deciding if you should wait for the new line up or buy it now"	"DO_QUESTION"
"When can I upgrade "	"I do not know when you can upgrade"	"WQUES"
"What kinds of cases are heard in City Court of Slidell "	"I do not know what kinds of cases are heard in City Court of Slidell"	"WQUES_SIMPLE"
"Do you know how often one user buys this item ? What is the usual time frame that this product runs out "	"I do not know if I know how often one user buys this item"	"DO_QUESTION"
"I forgot my password and need to make a new one"	"I do not know how to handle 'I forgot my password and need to make a new one'"	"CANONICAL_IDK"
"Does the museum have lockers , as well as a Cloakroom "	"I do not know if the museum has lockers , as well as a Cloakroom"	"DO_QUESTION"
"What does Nandi mean "	"I do not know what Nandi means"	"WQUES_SIMPLE"
"Are you able to give a refund if I do n't like the product "	"I do not know if I am able to give a refund if you n't like the product"	"BE_HAVE_MD_QUESTION"
"How can I share my ideas for future exhibits "	"I do not know how you can share your ideas for future exhibits"	"WQUES"
"I want to cancel my policy "	"I do not know how to cancel your policy"	"IMPERATIVE"
"Where do I go to have my new motorcycle serviced ? I do not know how my policy works concerning that "	"I do not know where you go to have your new motorcycle serviced"	"WQUES"
"Are there food and drinks provided for ArtScience Late "	"I do not know if there are food and drinks provided for ArtScience Late"	"BE_HAVE_MD_QUESTION"
"Are there scholarships for dance here at LCC "	"I do not know if there are scholarships for dance here at LCC"	"BE_HAVE_MD_QUESTION"
"I need to speak with someone about my 401k portfolio . Would you be able to help me "	"I do not know how to speak with someone about your 401k portfolio ."	"IMPERATIVE"
"How to buy"	"I do not know how to buy"	"WQUES_SIMPLE"
"How long does it take for products to ship "	"I do not know how long it takes for products to ship"	"WQUES"
"How often does your company service their cars "	"I do not know how often does my company service their cars"	"WQUES_SIMPLE"
"Will this be reflected on my AT&T Mobility statement "	"I do not know if this will be reflected on your AT&T Mobility statement"	"BE_HAVE_MD_QUESTION"
"I recently had a baby , got married/divorced , had a dependent graduate from college , or my spouse/partner 's benefits changed at his/her employer . How can I make the appropriate changes to my benefit selections "	"I do not know how to got"	"IMPERATIVE"
"How do I get an ID badge or door access to a research space "	"I do not know how you get an ID badge or door access to a research space"	"WQUES"
"Where can I download a foot size template for ordering shoes from your website "	"I do not know where you can download a foot size template for ordering shoes from my website"	"WQUES"
"Do you offer student discounts on your software "	"I do not know if I offer student discounts on my software"	"DO_QUESTION"
"Will I be locked up in a hotel during the trial "	"I do not know if you will be locked up in a hotel during the trial"	"BE_HAVE_MD_QUESTION"
"I qualified for a position in the past , but now I do n't qualify . How can that be "	"I do not know how can that be"	"WSUBJ"
"Which is the best tour "	"I do not know which the best tour is"	"WQUES"
"Where can I check to see if my machine is under warranty "	"I do not know where you can check to see if your machine is under warranty"	"WQUES"
"Does a consumer have to enter a username and password every time they wish to play a DRM protected video "	"I do not know if a consumer has to enter a username and password every time they wish to play a DRM protected video"	"DO_QUESTION"
"How long is kitchen craft 's Warranty"	"I do not know how long kitchen craft 's Warranty is"	"WQUES"
"What time do the lights come on "	"I do not know what time the lights come on"	"WQUES"
"Are there nearby places for a quick lunch "	"I do not know if there are nearby places for a quick lunch"	"BE_HAVE_MD_QUESTION"
"My package was damaged , what is the process of seeing if my parcel was insured "	"I do not know what is the process of seeing if your parcel was insured your package was damaged ,"	"WQUES"
"Is there a way to check online whether an item is in stock in a store"	"I do not know if there is a way to check online whether an item is in stock in a store"	"BE_HAVE_MD_QUESTION"
"I 'm not sure of the name of the ship my relative came here or served on -- can you help me "	"I do not know if I can help you"	"BE_HAVE_MD_QUESTION"
"Why is my video lagging when I watch "	"I do not know why your video is lagging when you watch"	"WQUES"
"Can you come on-site "	"I do not know if I can come on-site"	"BE_HAVE_MD_QUESTION"
"How do I get to Bethel Woods"	"I do not know how you get to Bethel Woods"	"WQUES"
"What is the incidental deposit policy "	"I do not know what the incidental deposit policy is"	"WQUES"
"If something breaks , where can I take it to get it fixed "	"I do not know where you can take it to get it fixed"	"WQUES"
"Am I required to provide my employees benefits "	"I do not know if you are required to provide your employees benefits"	"BE_HAVE_MD_QUESTION"
"What time was my item shipped today "	"I do not know what time your item was shipped today"	"WQUES"
"Must I complete the form at the consulate or must it be completed before I go to the consulate "	"I do not know if you must complete the form at the consulate or must it be completed before you go to the consulate"	"BE_HAVE_MD_QUESTION"
"Are there special limits in running credit checks on independent contractors "	"I do not know if there are special limits in running credit checks on independent contractors"	"BE_HAVE_MD_QUESTION"
"Do I need to purchase an extended warranty "	"I do not know if you need to purchase an extended warranty"	"DO_QUESTION"
"What is the average shipping time with your company "	"I do not know what the average shipping time with my company is"	"WQUES"
"Who can I contact if I have any questions or concerns about using my lawn pass"	"I do not know who you can contact if you have any questions or concerns about using your lawn pass"	"WQUES"
"Do only union employees have a right to engage in protected concerted activity over the internet "	"I do not know if only union employees have a right to engage in protected concerted activity over the internet"	"DO_QUESTION"
"As an employer , am I liable for sexual harassment at my company , even if I do n't know about it "	"I do not know how to as an"	"IMPERATIVE"
"Can you assist with filing my debt collection letter in preparation for my small claims court case on November 3rd "	"I do not know if I can assist with filing your debt collection letter in preparation for your small claims court case on November 3rd"	"BE_HAVE_MD_QUESTION"
"Why build a new courthouse "	"I do not know why build a new courthouse"	"WQUES_SIMPLE"
"If I delete my account is it really gone or do you save it somewhere "	"I do not know if it is really gone or I save it somewhere"	"BE_HAVE_MD_QUESTION"
"How long do I have to wait for the refund to show back up in my bank account "	"I do not know how long you have to wait for the refund to show back up in your bank account"	"WQUES"
"Do international employees need to complete the Selective Service Eligibility and Verification Form "	"I do not know if international employees need to complete the Selective Service Eligibility and Verification Form"	"DO_QUESTION"
"Looking to become part of the Museums ' staff "	"I do not know how to looking to become part of the Museums ' staff"	"IMPERATIVE"
"I ordered a custom product and am not sure if I can return it "	"I do not know how to handle 'I ordered a custom product and am not sure if I can return it '"	"CANONICAL_IDK"
"My cable service 's on demand function has not worked for three days due to internet connectivity , can a technician repair this for me "	"I do not know if a can technician repair this for you"	"BE_HAVE_MD_QUESTION"
"How much time should be allocated for a school / group visit to the zoo "	"I do not know how much time should be allocated for a school / group visit to the zoo"	"WQUES_SIMPLE"
"Can I receive academic credit for my participation in the Internship Program "	"I do not know if you can receive academic credit for your participation in the Internship Program"	"BE_HAVE_MD_QUESTION"
"Where should I purchase dance attire and shoes "	"I do not know where you should purchase dance attire and shoes"	"WQUES"
"Is there maternity/paternity leave "	"I do not know if there is maternity/paternity leave"	"BE_HAVE_MD_QUESTION"
"Do you offer any financing "	"I do not know if I offer any financing"	"DO_QUESTION"
"What carrier do you use to ship items "	"I do not know what carrier I use to ship items"	"WQUES"
"Can you verify the address this order is being shipped to "	"I do not know if I can verify the address this order is being shipped to"	"BE_HAVE_MD_QUESTION"
"My airline ticket was lost over the weekend can i get reimburse back my money "	"I do not know how to your airline ticket was lost over the weekend can you get reimburse back your money"	"IMPERATIVE"
"May an employer terminate an employee who exhausts Family and Medical Leave Act -LRB- FMLA -RRB- leave and does not return to work "	"I do not know if an employer may terminate an employee who exhausts Family and Medical Leave Act -LRB- FMLA -RRB- leave and not returns to work"	"BE_HAVE_MD_QUESTION"
"what are the hours of your store "	"I do not know what the hours of my store are"	"WQUES"
"What constitutes a ' public ' screening "	"I do not know what constitutes a ' public ' screening"	"WSUBJ"
"Can I pay by check "	"I do not know if you can pay by check"	"BE_HAVE_MD_QUESTION"
"Can you help me track down my lost luggage "	"I do not know if I can help you track down your lost luggage"	"BE_HAVE_MD_QUESTION"
"Last year , my parents and I both took out student loans for me . We both received Form 1098-E for our separate loans . I was n't their dependent last year . Can we both claim student loan interest on our tax returns "	"I do not know how to last"	"IMPERATIVE"
"Will my insurance rates go up if I get into an accident "	"I do not know if your insurance rates will go up if you get into an accident"	"BE_HAVE_MD_QUESTION"
"How do I rent your facility for a birthday party "	"I do not know how you rent my facility for a birthday party"	"WQUES"
"How can I help "	"I do not know how you can help"	"WQUES"
"What shipping carier do you use "	"I do not know what shipping carier I use"	"WQUES"
"What is the APR on your financial option "	"I do not know what the APR on my financial option is"	"WQUES"
"Where is the gift shop "	"I do not know where the gift shop is"	"WQUES"
"Why did they not include the AVP series in this movie "	"I do not know why they not included the AVP series in this movie"	"WQUES"
"Are there any positions available at the Museum "	"I do not know if there are any positions available at the Museum"	"BE_HAVE_MD_QUESTION"
"Would it be possible to ship my monthly subscribe and save order 1 week early "	"I do not know if it would be possible to ship your monthly subscribe and save order 1 week early"	"BE_HAVE_MD_QUESTION"
"Do you sell ypur online products in-store "	"I do not know if I sell ypur online products in-store"	"DO_QUESTION"
"Does your store price match branded bags with online price if I have to stop by and purchase an item "	"I do not know if my store price match branded bags with online price if you have to stop by and purchase an item"	"DO_QUESTION"
"Do you do tours "	"I do not know if I do tours"	"DO_QUESTION"
"Do you have educational programs "	"I do not know if I have educational programs"	"DO_QUESTION"
"How do I know which product is right for me "	"I do not know how you know which product is right for you"	"WQUES"
"When is this newest product going to be available "	"I do not know when is this newest product going to be available"	"WQUES_SIMPLE"
"I 'm trying to find a place that will board pets for 2-3 nights on short notice . Does your place do anything like that "	"I do not know you to find a place that will board pets for 2-3 nights on short notice you are trying ."	"WQUES"
"Should I call ahead before coming in for research "	"I do not know if you should call ahead before coming in for research"	"BE_HAVE_MD_QUESTION"
"What is your daily admission fee "	"I do not know what my daily admission fee is"	"WQUES"
"Are international transit times always met "	"I do not know if international transit times are always met"	"BE_HAVE_MD_QUESTION"
"Can you reserve the Museum for events "	"I do not know if I can reserve the Museum for events"	"BE_HAVE_MD_QUESTION"
"How do I terminate my software license contract "	"I do not know how you terminate your software license contract"	"WQUES"
"I need to change the date of my monthly payment from the 1st to the 15th of each month "	"I do not know how to change the date of your monthly payment from the 1st to the 15th of each month"	"IMPERATIVE"
"How do I make a correction to my online order "	"I do not know how you make a correction to your online order"	"WQUES"
"What name should I enter in my account "	"I do not know what name you should enter in your account"	"WQUES"
"Are there any deferment options for my next payment "	"I do not know if there are any deferment options for your next payment"	"BE_HAVE_MD_QUESTION"
"What is the difference between a tourist visa and a business visa "	"I do not know what the difference between a tourist visa and a business visa is"	"WQUES"
"My tracking shows that item is delivered but I have n't received it yet , could you please check it"	"I do not know if I could check it"	"BE_HAVE_MD_QUESTION"
"How can I change my appointment to a later time on September 4th ? I have another appointment and need to reschedule please "	"I do not know how you can change your appointment to a later time on September 4th"	"WQUES"
"If I buy a flight ticket with ANA SKY COIN , do I have to use the flight ticket within the ANA SKY COIN period of validity "	"I do not know if you have to use the flight ticket within the ANA SKY COIN period of validity"	"DO_QUESTION"
"What is one serving "	"I do not know what is one serving"	"WQUES"
"What flavors do you offer of this item "	"I do not know what flavors I offer of this item"	"WQUES"
"Will my product be repaired or replaced under warranty "	"I do not know if your product will be repaired or replaced under warranty"	"BE_HAVE_MD_QUESTION"
"WHAT ARE THE STADIUM TOURS & MUSEUM OPENING HOURS"	"I do not know what ARE THE STADIUM TOURS & MUSEUM OPENING HOURS"	"WSUBJ"
"There 's been a lot of flooding in my area ; is this going to affect how long it takes my item to arrive "	"I do not know this to affect how long it takes your item to arrive this is going"	"WQUES"
"My spouse and I are filing as married filing separately . We both contributed to the support of our son . Can we both claim a dependency exemption for him on our separate returns "	"I do not know if you both can claim a dependency exemption for him on your separate returns"	"BE_HAVE_MD_QUESTION"
"How can I find out the status of my order "	"I do not know how you can find out the status of your order"	"WQUES"
"I 'm unable to find an old order on my history "	"I do not know how to handle 'I 'm unable to find an old order on my history '"	"CANONICAL_IDK"
"Can I view the security questions that I set up "	"I do not know if you can view the security questions that you set up"	"BE_HAVE_MD_QUESTION"
"Can I change the day on my flight from New York to Vancouver from Wednesday to friday "	"I do not know if you can change the day on your flight from New York to Vancouver from Wednesday to friday"	"BE_HAVE_MD_QUESTION"
"I just received my new phone . How do I port my number from my old carrier to this service "	"I do not know how do you port your number from your old carrier to this service"	"WQUES_SIMPLE"
"Do I receive a discount on admission tickets purchased for guests "	"I do not know if you receive a discount on admission tickets purchased for guests"	"DO_QUESTION"
"Once I enter the venue , can I leave and return"	"I do not know if you can leave and return"	"BE_HAVE_MD_QUESTION"
"How do I report equipment that is returned to IBM or sold to another business "	"I do not know how you report equipment that is returned to IBM or sold to another business"	"WQUES"
"Can I apply in person , using a paper application "	"I do not know if you can apply in person , using a paper application"	"BE_HAVE_MD_QUESTION"
"Can I have the delivery date for this package sent to me at an earlier time instead of later "	"I do not know if you can have the delivery date for this package sent to you at an earlier time instead of later"	"BE_HAVE_MD_QUESTION"
"Do you need the last 4 digits of my social "	"I do not know if I need the last 4 digits of your social"	"DO_QUESTION"
"Will my membership card be mailed to me "	"I do not know if your membership card will be mailed to you"	"BE_HAVE_MD_QUESTION"
"When does a private lesson package expire"	"I do not know when a private lesson package expires"	"WQUES"
"Is an employer required to shred paperwork that contains personal information "	"I do not know if an employer is required to shred paperwork that contains personal information"	"BE_HAVE_MD_QUESTION"
"I placed an order so why have I not received a confirmation email"	"I do not know so why you have not received a confirmation email"	"WQUES"
"Are there optional upgrades to the standard Powertrain Coverage "	"I do not know if there are optional upgrades to the standard Powertrain Coverage"	"BE_HAVE_MD_QUESTION"
"Where can I get information on volunteering at the Museum "	"I do not know where you can get information on volunteering at the Museum"	"WQUES"
"Is there a chance I can pay once for a yearly subscription instead of monthly "	"I do not know if there is a chance you can pay once for a yearly subscription instead of monthly"	"BE_HAVE_MD_QUESTION"
"Where can I find 2018 plans and prices "	"I do not know where you can find 2018 plans and prices"	"WQUES"
"Must I serve if I am not a United States citizen "	"I do not know if you must serve if you are not a United States citizen"	"BE_HAVE_MD_QUESTION"
"If a taxpayer adopts the child of his or her registered domestic partner as a second parent or co-parent , may the taxpayer -LRB- ' adopting parent ' -RRB- claim the adoption credit for the qualifying adoption expenses he or she pays to adopt the child "	"I do not know if the taxpayer -LRB- ' adopting parent ' -RRB- may claim the adoption credit for the qualifying adoption expenses he or she pays to adopt the child"	"BE_HAVE_MD_QUESTION"
"What kinds of alcohol are available in Guatemala"	"I do not know what kinds of alcohol are available in Guatemala"	"WQUES_SIMPLE"
"Do you plan to produce an online format "	"I do not know if I plan to produce an online format"	"DO_QUESTION"
"Are service dogs allowed at the zoo "	"I do not know if service dogs are allowed at the zoo"	"BE_HAVE_MD_QUESTION"
"Would it be faster if I picked up the order instead "	"I do not know if it would be faster if you picked up the order instead"	"BE_HAVE_MD_QUESTION"
"I placed an order yesterday , can you tell me what account that is on "	"I do not know you placed an order yesterday , can I tell you what account that is on"	"WSUBJ"
"Is it possible to change the shipping address on something I ordered yesterday "	"I do not know if it is possible to change the shipping address on something you ordered yesterday"	"BE_HAVE_MD_QUESTION"
"What can be done for an employee whose court-ordered garnishments are an excessive burden "	"I do not know for an employee whose court-ordered garnishments are an excessive burden What can be done"	"WQUES"
"What methods of payment can I use online "	"I do not know what methods of payment you can use online"	"WQUES"
"How does KAM manage image rights and permissions for art in the permanent collection "	"I do not know how KAM manages image rights and permissions for art in the permanent collection"	"WQUES"
"Why is n't my photo showing in Self Service "	"I do not know why is n't your photo showing in Self Service"	"WQUES_SIMPLE"
"May an employer charge more for the same benefit provided to different employees "	"I do not know if an may employer charge more for the same benefit provided to different employees"	"BE_HAVE_MD_QUESTION"
"Ca n't find what you are looking for "	"I do not know if n't find what I am looking ca for"	"BE_HAVE_MD_QUESTION"
"How much will it cost to repair my phone screen "	"I do not know how much it will cost to repair your phone screen"	"WQUES"
"Is there any way my rate can be lowered "	"I do not know if there is any way your rate can be lowered"	"BE_HAVE_MD_QUESTION"
"Is the Museum usually crowded with school groups "	"I do not know if the Museum is usually crowded with school groups"	"BE_HAVE_MD_QUESTION"
"Can I pay with PayPal on an order "	"I do not know if you can pay with PayPal on an order"	"BE_HAVE_MD_QUESTION"
"Do nonexempt employees have to be paid for their commutes if they are using a company car "	"I do not know if nonexempt employees have to be paid for their commutes if they are using a company car"	"DO_QUESTION"
"Is there an indoor place where I can breastfeed my baby "	"I do not know if there is an indoor place where you can breastfeed your baby"	"BE_HAVE_MD_QUESTION"
"Tell me how to change the mailing address for my account , it just wo n't let me update anything"	"I do not know how you to change the mailing address for your account"	"WQUES"
"Is the price of shipping included in the kit price "	"I do not know if the price is of shipping included in the kit price"	"BE_HAVE_MD_QUESTION"
"If tickets for the event are listed as sold-out online , does that mean I ca n't come "	"I do not know how to if tickets for the event are listed as sold-out"	"IMPERATIVE"
"If my child is sick or misses class for any other reason , can she/he make it up "	"I do not know how to can she/he make it up"	"IMPERATIVE"
"I wanted to check on my airline reservation . Are their any aisle seats available on my outbound flight "	"I do not know how to check on your airline reservation ."	"IMPERATIVE"
"Does this program apply to me if I am not receiving home and community based waiver services or nursing home services "	"I do not know if this program applies to you if you are not receiving home and community based waiver services or nursing home services"	"DO_QUESTION"
"How does one modify the contents of an order ? There 's a few things I no longer need in this package"	"I do not know how one modifies the contents of an order"	"WQUES_SIMPLE"
"What age are the dancers "	"I do not know what age the dancers are"	"WQUES"
"When is my best chance for getting through if I 'm trying to talk to a manager ? I 've been calling every day for the last week "	"I do not know when your best chance for getting through if you are trying to talk to a manager is"	"WQUES"
"Can I get my invoice emailed to me from now on "	"I do not know if you can get your invoice emailed to you from now on"	"BE_HAVE_MD_QUESTION"
"How much does TurboTax Online cost "	"I do not know how much does TurboTax Online cost"	"WQUES_SIMPLE"
"The dress I ordered arrived with a tear in it ; can I get some kind of discount "	"I do not know if you can get some kind of discount"	"BE_HAVE_MD_QUESTION"
"Is my membership at Science Museum Oklahoma valid at other Oklahoma museums "	"I do not know if your membership is at Science Museum Oklahoma valid at other Oklahoma museums"	"BE_HAVE_MD_QUESTION"
"Is it possible to book a traveling zoo program for a birthday "	"I do not know if it is possible to book a traveling zoo program for a birthday"	"BE_HAVE_MD_QUESTION"
"Can I cancel an order mid-shipment "	"I do not know if you can cancel an order mid-shipment"	"BE_HAVE_MD_QUESTION"
"how can I track my package once it 's been shipped"	"I do not know how you can track your package once it 's been shipped"	"WQUES"
"What is the procedure to follow to obtain authorization to shoot "	"I do not know what the procedure to follow to obtain authorization to shoot is"	"WQUES"
"What do I do if I 'm having chest pains "	"I do not know what you do if you are having chest pains"	"WQUES"
"What is a manufacturer 's warranty "	"I do not know what a manufacturer 's warranty is"	"WQUES"
"Can I add foster children to our membership"	"I do not know if you can add foster children to your membership"	"BE_HAVE_MD_QUESTION"
"Is the house air conditioned "	"I do not know if the house air is conditioned"	"BE_HAVE_MD_QUESTION"
"Do you have anybody here who can help me with decorating designs for my home "	"I do not know if I have anybody here who can help you with decorating designs for your home"	"DO_QUESTION"
"Can I get technical assistance on the parts "	"I do not know if you can get technical assistance on the parts"	"BE_HAVE_MD_QUESTION"
"I exercised my rights to receive life insurance distributions before death . Are these proceeds taxable "	"I do not know if these proceeds are taxable"	"BE_HAVE_MD_QUESTION"
"What is a ' Course ' "	"I do not know what a ' Course ' is"	"WQUES"
"How can I change the shipping address on an order I placed that 's already marked as shipped "	"I do not know how you can change the shipping address on an order you placed that 's already marked as shipped"	"WQUES"
"What does the scholarship cover "	"I do not know what does the scholarship cover"	"WQUES_SIMPLE"
"My new microwave was just delivered but it 's broken "	"I do not know how to your new microwave was just delivered but it 's broken"	"IMPERATIVE"
"Can I register several sensors on one account "	"I do not know if you can register several sensors on one account"	"BE_HAVE_MD_QUESTION"
"What day should I expect my package to arrive at my doorstep "	"I do not know what day you should expect your package to arrive at your doorstep"	"WQUES"
"Do you offer a store credit card "	"I do not know if I offer a store credit card"	"DO_QUESTION"
"what is the true description of a sardine "	"I do not know what the true description of a sardine is"	"WQUES"
"What should I know before I arrive "	"I do not know what you should know before you arrive"	"WQUES"
"How am I charged for The Verizon Plan "	"I do not know how you are charged for The Verizon Plan"	"WQUES"
"How do I set up a subscription "	"I do not know how you set up a subscription"	"WQUES"
"What is your most popular add on item that people buy "	"I do not know what my most popular add on item that people buy"	"WQUES"
"Do you have an address where I can return clothe ? I lost the packing slip , is that OK just to print out order confirmation email "	"I do not know if I have an address where you can return clothe"	"DO_QUESTION"
"If we get disconnected , can you call me back on my cell phone or do I have to call you back "	"I do not know if I can call you back on your cell phone or you have to call me back"	"BE_HAVE_MD_QUESTION"
"Which countries take part in the Schengen Agreement "	"I do not know which countries take part in the Schengen Agreement"	"WQUES_SIMPLE"
"I have a paper due next week and would like to get some information on the waterways in PA , could you let me know where on your website I can find this "	"I do not know where you on my website can find this"	"WQUES"
"Does your salon work with kids "	"I do not know if my salon work with kids"	"DO_QUESTION"
"How long is your current advertisement good for "	"I do not know how long is my current advertisement good for"	"WQUES_SIMPLE"
"I have an order in transit to my home that I 'd like to cancel . What is your policy on cancellations "	"I do not know what my policy on cancellations is"	"WQUES"
"How long can I stay in Guatemala"	"I do not know how long you can stay in Guatemala"	"WQUES"
"How may I change my mailing address , email address or any other personal information "	"I do not know how you may change your mailing address , email address or any other personal information"	"WQUES"
"How can I stay in contact with the Museum "	"I do not know how you can stay in contact with the Museum"	"WQUES"
"If I win my case , what am I entitled to "	"I do not know what you are entitled to"	"WQUES"
"I understand that networking is important at work , but I am fairly introverted . Any ideas "	"I do not know how to any ideas"	"IMPERATIVE"
"where can I find your privacy policy "	"I do not know where you can find my privacy policy"	"WQUES"
"How to delete/unbound Nut "	"I do not know how to delete/unbound Nut"	"WQUES_SIMPLE"
"I 've heard that I need a waiting number to get into the Chichu Art Museum and the Minamidera -LRB- Art House Project -RRB- when they are crowded "	"I do not know when they are crowded"	"WQUES"
"Can you tell me if the shirt I ordered can be switched to a different size "	"I do not know if I can tell you if the shirt you ordered can be switched to a different size"	"BE_HAVE_MD_QUESTION"
"I need an update on my order "	"I do not know how to an update on your order"	"IMPERATIVE"
"Can I lose weight with this product "	"I do not know if you can lose weight with this product"	"BE_HAVE_MD_QUESTION"
"Are your aircraft flight worthy "	"I do not know if my aircraft flight are worthy"	"BE_HAVE_MD_QUESTION"
"When is my $ 100 non-refundable Deposit Due "	"I do not know when your $ 100 non-refundable Deposit Due is"	"WQUES"
"How much do the dances cost and can anyone come "	"I do not know how much do the dances cost and can anyone come"	"WQUES_SIMPLE"
"How much does it cost to visit the Tombstone Epitaph Museum "	"I do not know how much it costs to visit the Tombstone Epitaph Museum"	"WQUES"
"Can you match a price I just found somewhere else "	"I do not know if I can match a price you just found somewhere else"	"BE_HAVE_MD_QUESTION"
"What happens after the free trial "	"I do not know what happens after the free trial"	"WSUBJ"
"Order me khaki pants"	"I do not know how to Order you khaki pants"	"IMPERATIVE"
"What type of camera does your new phone have "	"I do not know what type of camera my new phone has"	"WQUES_SIMPLE"
"Does SMoCA have a rental program "	"I do not know if smoca have a rental program"	"DO_QUESTION"
"How do I cancel this service "	"I do not know how you cancel this service"	"WQUES"
"How many people visit the national parks "	"I do not know how many people visit the national parks"	"WQUES_SIMPLE"
"Is there a parent drop off area "	"I do not know if there is a parent drop off area"	"BE_HAVE_MD_QUESTION"
"Can I take photos during my visit "	"I do not know if you can take photos during your visit"	"BE_HAVE_MD_QUESTION"
"How much does it cost to join "	"I do not know how much it costs to join"	"WQUES"
"Does the Federal Reserve tell the public what it holds on its balance sheet "	"I do not know if the Federal Reserve tells the public what it holds on its balance sheet"	"DO_QUESTION"
"I get your paper daily , but will be going on vacation at the end of this month . Can I get credited and stop delivery so I do n't have papers in front of my house while I 'm away "	"I do not know how to but will be going on vacation at the end of this"	"IMPERATIVE"
"Before Camp : What should my camper bring to camp "	"I do not know what your camper should bring to camp"	"WQUES"
"Can I retrieve my messages for a different telephone number without having to hang up and redial into the voicemail system "	"I do not know if you can retrieve your messages for a different telephone number without having to hang up and redial into the voicemail system"	"BE_HAVE_MD_QUESTION"
"Who is the administrative contact , and who is the technical contact "	"I do not know who is the administrative contact , and who is the technical contact"	"WSUBJ"
"How are Travel Advice and Advisories developed and maintained "	"I do not know how Travel Advice and Advisories are Advisories developed and maintained"	"WQUES"
"I Am Disabled ; will I be able to go on a stadium tour at Emirates Stadium"	"I do not know if you will be able to go on a stadium tour at Emirates Stadium"	"BE_HAVE_MD_QUESTION"
"Can I book a one-way car rental "	"I do not know if you can book a one-way car rental"	"BE_HAVE_MD_QUESTION"
"I have n't received my package yet , could you check on it for me "	"I do not know if I could check on it for you"	"BE_HAVE_MD_QUESTION"
"Once I am issued a visa , can I travel all over Russia "	"I do not know how to once you are issued a"	"IMPERATIVE"
"I wanted to change my health plan , so can i do that online or do i need to talk to an agent "	"I do not know how to change your health"	"IMPERATIVE"
"I am an Irish national . My spouse / civil partner is a visa required national . Do they need a visa to visit/live in Ireland "	"I do not know how to your"	"IMPERATIVE"
"I was at one of your locations and fell due to a spill on your floor . Who do I need to talk to about filing an incident report "	"I do not know who you need to talk to about filing an incident report"	"WQUES"
"May I make an employment offer contingent upon successfully passing a physical "	"I do not know if you may make an employment offer contingent upon successfully passing a physical"	"BE_HAVE_MD_QUESTION"
"Can I see my vacation and sick accrual balance "	"I do not know if you can see your vacation and sick accrual balance"	"BE_HAVE_MD_QUESTION"
"Can I switch to another carrier without paying an Early Termination Fee before my service transitions to AT&T "	"I do not know if you can switch to another carrier without paying an Early Termination Fee before your service transitions to AT&T"	"BE_HAVE_MD_QUESTION"
"Is the seafood quality"	"I do not know if the is seafood quality"	"BE_HAVE_MD_QUESTION"
"There are purchases I did n't make on my statement , can I speak to someone about it "	"I do not know if you can speak to someone about it"	"BE_HAVE_MD_QUESTION"
"Is there an account manager I can speak to "	"I do not know if there is an account manager you can speak to"	"BE_HAVE_MD_QUESTION"
"Where do I submit my student organization "	"I do not know where you submit your student organization"	"WQUES"
"I forgot to clock in/out how do I fix my time "	"I do not know how you fix your time"	"WQUES"
"Is there a website that can show me everything in box office history "	"I do not know if there is a website that can show you everything in box office history"	"BE_HAVE_MD_QUESTION"
"What can I do to have my package sent to another location aside from the one on my order "	"I do not know what you can do to have your package sent to another location aside from the one on your order"	"WQUES"
"Can I have a device payment agreement without an active Verizon Wireless mobile number "	"I do not know if you can have a device payment agreement without an active Verizon Wireless mobile number"	"BE_HAVE_MD_QUESTION"
"Will my insurance company pay for a rental if I was in a wreck "	"I do not know if your insurance company will pay for a rental if you were in a wreck"	"BE_HAVE_MD_QUESTION"
"How is check - in or registration handled for the competition "	"I do not know how is check - in or registration handled for the competition"	"WQUES_SIMPLE"
"I was wondering if there were any promotional specials going on "	"I do not know how to handle 'I was wondering if there were any promotional specials going on '"	"CANONICAL_IDK"
"What types of photography or videography are allowed in the Museum "	"I do not know what types of photography or videography are allowed in the Museum"	"WQUES_SIMPLE"
"Which Airlines fly to Panama from which US and Europe and from which cities "	"I do not know from which you and Europe and from which cities Which Airlines fly to Panama"	"WQUES"
"Can I get a confirmation number "	"I do not know if you can get a confirmation number"	"BE_HAVE_MD_QUESTION"
"Does your company have any plans to open up any more of your burger restaurants in other areas "	"I do not know if my company have any plans to open up any more of my burger restaurants in other areas"	"DO_QUESTION"
"Can I leave the museum and come today"	"I do not know if you can leave the museum and come today"	"BE_HAVE_MD_QUESTION"
"Do you have to be a certain age to attend "	"I do not know if I have to be a certain age to attend"	"DO_QUESTION"
"Do members receive a discount at the gift shops "	"I do not know if members receive a discount at the gift shops"	"DO_QUESTION"
"The other day I noticed that your restaurants hours had gotten shorter , can you explain why "	"I do not know why my restaurants hours had gotten shorter that , can I explain"	"WQUES"
"How many animals does the Zoo have "	"I do not know how many animals the Zoo has"	"WQUES_SIMPLE"
"What type of organization is the Museum "	"I do not know what type of organization the Museum is"	"WQUES"
"Can the Gallery appraise my artwork or artifacts "	"I do not know if the Gallery can appraise your artwork or artifacts"	"BE_HAVE_MD_QUESTION"
"How come the monthly fee is going up "	"I do not know how come the monthly fee is going up"	"WQUES"
"How much does parking cost and where do I pay "	"I do not know where you pay"	"WQUES"
"Does this shirt come in children 's sizes "	"I do not know if this shirt comes in children 's sizes"	"DO_QUESTION"
"How should an employer handle a bomb threat "	"I do not know how an employer should handle a bomb threat"	"WQUES"
"Do you insure your products when you ship them "	"I do not know if I insure my products when I ship them"	"DO_QUESTION"
"How many people live in Corning "	"I do not know how many people live in Corning"	"WQUES_SIMPLE"
"How can I track my order "	"I do not know how you can track your order"	"WQUES"
"Do you have anything on discount "	"I do not know if I have anything on discount"	"DO_QUESTION"
"Does your store carry heirloom seeds "	"I do not know if my store carry heirloom seeds"	"DO_QUESTION"
"Could you assist me with my luggage "	"I do not know if I could assist you with your luggage"	"BE_HAVE_MD_QUESTION"
"What are Blue Credits "	"I do not know what Blue Credits are"	"WQUES"
"I am not receiving membership emails . How do I SIGN UP TO RECEIVE THEM"	"I do not know how you SIGN UP TO RECEIVE THEM"	"WQUES"
"What are my options , now that my car lease is almost up "	"I do not know what are your options , now that your car lease is almost up"	"WQUES_SIMPLE"
"When does the Dance Department hold scholarship auditions "	"I do not know when the Dance Department holds scholarship auditions"	"WQUES"
"I need to change my phone number"	"I do not know how to change your phone number"	"IMPERATIVE"
"How does E-TRAC handle multiple approver at the same level "	"I do not know how E-TRAC handles multiple approver at the same level"	"WQUES"
"How do I return a school book rental once the semester is over "	"I do not know how you return a school book rental once the semester is over"	"WQUES"
"What is included in the admission price "	"I do not know what is included in the admission price"	"WQUES_SIMPLE"
"Are there tours for people with visual impairments "	"I do not know if there tours are for people with visual impairments"	"BE_HAVE_MD_QUESTION"
"What happens if my card is lost or stolen "	"I do not know what happens if your card is lost or stolen"	"WSUBJ"
"Where can I find primary sources about the transcontinental railroad "	"I do not know where you can find primary sources about the transcontinental railroad"	"WQUES"
"How is a side pot is shared "	"I do not know how a side pot is is shared"	"WQUES"
"Can I ask how much are tickets going to be next month , to San Francisco by plane "	"I do not know if you can ask how much are tickets going to be next month , to San Francisco by plane"	"BE_HAVE_MD_QUESTION"
"If it says zero in stock , is that really true "	"I do not know if that is really true"	"BE_HAVE_MD_QUESTION"
"Why do you need to see my ID to notarize this document "	"I do not know why I need to see your ID to notarize this document"	"WQUES"
"Can I copyright the name of my band "	"I do not know if you can copyright the name of your band"	"BE_HAVE_MD_QUESTION"
"Once an individual 's DACA expires , will their case be referred to ICE for enforcement purposes "	"I do not know how to once an individual 's DACA"	"IMPERATIVE"
"What coverage would you recommend for me "	"I do not know what coverage I would recommend for you"	"WQUES"
"What is the duration for ArtScience Late "	"I do not know what the duration for ArtScience Late is"	"WQUES"
"I ordered my laptop computer cooler over two weeks ago . How long will it be until I get my order "	"I do not know how long will it be until you get your order"	"WQUES_SIMPLE"
"Are the Reserve Banks ' boards of directors involved in banking supervision matters "	"I do not know if the Reserve Banks ' boards are of directors involved in banking supervision matters"	"BE_HAVE_MD_QUESTION"
"Do you have any new products "	"I do not know if I have any new products"	"DO_QUESTION"
"I need to change the details for my credit card info "	"I do not know how to change the details for your credit card info"	"IMPERATIVE"
"Can you tell me why me subscription has not arrived"	"I do not know if I can tell you why you subscription has not arrived"	"BE_HAVE_MD_QUESTION"
"Are pets allowed at the Air Museum "	"I do not know if pets are allowed at the Air Museum"	"BE_HAVE_MD_QUESTION"
"What documents should I receive from my employer "	"I do not know what documents you should receive from your employer"	"WQUES"
"Does my company provide a discount on this service "	"I do not know if your company provide a discount on this service"	"DO_QUESTION"
"I was supposed to be picking up an online order , but I need to send someone else to pick it up - how do I do that "	"I do not know how you do that"	"WQUES"
"How far back may an employer search into a job applicant 's past for criminal convictions "	"I do not know how far back may an employer search into a job applicant 's past for criminal convictions"	"WQUES_SIMPLE"
"Do you have a petting zoo "	"I do not know if I have a petting zoo"	"DO_QUESTION"
"When purchasing flight tickets with ANA SKY COIN , how do I pay the remaining balance "	"I do not know how you pay the remaining balance"	"WQUES"
"How do I renew my membership online "	"I do not know how you renew your membership online"	"WQUES"
"How can I purchase or renew a membership "	"I do not know how you can purchase or renew a membership"	"WQUES"
"Is there a limit to the amount of calls I can make with Robo-Dialer "	"I do not know if there is a limit to the amount of calls you can make with Robo-Dialer"	"BE_HAVE_MD_QUESTION"
"Can I use a gift card to purchase a membership"	"I do not know if you can use a gift card to purchase a membership"	"BE_HAVE_MD_QUESTION"
"Do you offer Kosher catering "	"I do not know if I offer Kosher catering"	"DO_QUESTION"
"How do we take MAX to the zoo "	"I do not know how you take MAX to the zoo"	"WQUES"
"What 's The Verizon Plan , and can I still sign up for it "	"I do not know what The Verizon Plan 's"	"WQUES"
"What is the address for your corporate headquarters ? I 'd like to mail a letter to your president "	"I do not know what the address for my corporate headquarters is"	"WQUES"
"I keep receiving emails from your company , can you remove me from the mailing list "	"I do not know if I can remove you from the mailing list"	"BE_HAVE_MD_QUESTION"
"Are video files ever left unencrypted on consumer 's storage "	"I do not know if video files are ever left unencrypted on consumer 's storage"	"BE_HAVE_MD_QUESTION"
"Can an employer terminate an employee who is out on FMLA leave "	"I do not know if an employer can terminate an employee who is out on FMLA leave"	"BE_HAVE_MD_QUESTION"
"Can we buy an annual pass to the zoo "	"I do not know if you can buy an annual pass to the zoo"	"BE_HAVE_MD_QUESTION"
"I 'm trying to create a landing page for my business on your website . Is there a way for me to see my page as a customer "	"I do not know if there is a way for you to see your page as a customer"	"BE_HAVE_MD_QUESTION"
"I only buy products made in the United States . Can you tell me where your products are manufactured "	"I do not know if I can tell you where my products are manufactured"	"BE_HAVE_MD_QUESTION"
"Does Dance Studio No. 1 have a dress code "	"I do not know if Dance Studio No. 1 have a dress code"	"DO_QUESTION"
"How far is the Zoo from Colwyn Bay Town Centre "	"I do not know how far the Zoo is from Colwyn Bay Town Centre"	"WQUES"
"Who do I contact to change the address on my invoice "	"I do not know who you contact to change the address on your invoice"	"WQUES"
"Does your company have a direct contact for the courier "	"I do not know if my company have a direct contact for the courier"	"DO_QUESTION"
"How is an offer of COBRA continuation coverage reported under Sections 6055 and 6056 "	"I do not know how an offer of COBRA continuation coverage reported under Sections 6055 and 6056 is"	"WQUES"
"What support do you offer for students with a disability or dyslexia "	"I do not know what support I offer for students with a disability or dyslexia"	"WQUES"
"I would like to change my address . Can you do that for me "	"I do not know how to change your address ."	"IMPERATIVE"
"What amenities are available at each CINÉPOLIS location"	"I do not know what amenities are available at each CINÉPOLIS location"	"WQUES_SIMPLE"
"What if I just want to send a check for my purchase "	"I do not know what you if just want to send a check for your purchase"	"WQUES"
"What should I do if I forget my account Password"	"I do not know what you should do if you forget your account Password"	"WQUES"
"CAN MEMBERSHIPS BE SHARED"	"I do not know how to CAN MEMBERSHIPS BE SHARED"	"IMPERATIVE"
"What are the benefits for silver membership "	"I do not know what the benefits for silver membership are"	"WQUES"
"How much does ZooLights cost for members "	"I do not know how much does ZooLights cost for members"	"WQUES_SIMPLE"
"Will you help me find chapstick"	"I do not know if I will help you find chapstick"	"BE_HAVE_MD_QUESTION"
"Are your cabinets fully assembled or ready to assemble -LRB- RTA -RRB- "	"I do not know if my cabinets are fully assembled or ready to assemble -LRB- RTA -RRB-"	"BE_HAVE_MD_QUESTION"
"Is it easy to learn"	"I do not know if it is easy to learn"	"BE_HAVE_MD_QUESTION"
"Is Membership a value for me"	"I do not know if membership a value is for you"	"BE_HAVE_MD_QUESTION"
"Do you sell rock hammers , tumblers or other rock hounding equipment "	"I do not know if I sell rock hammers , tumblers or other rock hounding equipment"	"DO_QUESTION"
"Can I use united.com check-in when I have bags to check "	"I do not know if you can use united.com check-in when you have bags to check"	"BE_HAVE_MD_QUESTION"
"Will you provide a return shipping label "	"I do not know if I will provide a return shipping label"	"BE_HAVE_MD_QUESTION"
"How many slots are available "	"I do not know how many slots are available"	"WQUES_SIMPLE"
"Any good ingredients are in belVita Breakfast Biscuits , Golden Oat "	"I do not know how to Golden Oat"	"IMPERATIVE"
"What is Intel ® Threading Building Blocks -LRB- Intel ® TBB -RRB- "	"I do not know what Intel ® Threading Building Blocks -LRB- Intel ® TBB -RRB- is"	"WQUES"
"I was thinking a 2 story house , can you show me some "	"I do not know if I can show you some"	"BE_HAVE_MD_QUESTION"
"Does the name on my airline reservation have to match the name on my application "	"I do not know if the name on your airline reservation has to match the name on your application"	"DO_QUESTION"
"What will I need to do to add my daughter to my automobile policy "	"I do not know what you will need to do to add your daughter to your automobile policy"	"WQUES"
"How does the guest/caregiver benefit work "	"I do not know how does the guest/caregiver benefit work"	"WQUES_SIMPLE"
"The party includes all day admission , when can my guests arrive "	"I do not know when your guests can arrive"	"WQUES"
"How much for the special today "	"I do not know how much for the special today"	"WQUES_SIMPLE"
"I received the dress that I ordered from your company . There is a flaw in the dress and I need to know how to send it back for a refund . Can you help me on this "	"I do not know you need to know how to send it back for a refund a flaw in the dress There is and ."	"WQUES"
"What should I wear/bring for Class"	"I do not know what you should wear/bring for Class"	"WQUES"
"How can I get a copy of my driving record or vehicle records "	"I do not know how you can get a copy of your driving record or vehicle records"	"WQUES"
"I have taken a photograph of ' The Thinker ' by Rodin in the museum 's front garden . Is it possible to use this picture "	"I do not know if it is possible to use this picture"	"BE_HAVE_MD_QUESTION"
"I have a package being shipped , are you able to check on its status "	"I do not know if I am able to check on its status"	"BE_HAVE_MD_QUESTION"
"How do I reset my My JH password "	"I do not know how you reset your your JH password"	"WQUES"
"How do I tell the difference between honeybees and other stinging insects "	"I do not know how you tell the difference between honeybees and other stinging insects"	"WQUES"
"Is the Berkshire Museum changing their mission statement "	"I do not know if the Berkshire Museum is changing their mission statement"	"BE_HAVE_MD_QUESTION"
"As a Member , do I get preferred parking "	"I do not know how to as a"	"IMPERATIVE"
"When can I expect my refund "	"I do not know when you can expect your refund"	"WQUES"
"Does this car have a back up camera "	"I do not know if this car has a back up camera"	"DO_QUESTION"
"How much of your products are made from recycled materials "	"I do not know how much of my products are made from recycled materials"	"WQUES_SIMPLE"
"Where do I find the Trinity Salary Scales "	"I do not know where you find the Trinity Salary Scales"	"WQUES"
"Can my item come in a custom box "	"I do not know if your item can come in a custom box"	"BE_HAVE_MD_QUESTION"
"I have n't seen any confirmation emails . Why I am not receiving emails "	"I do not know why you are not receiving emails"	"WQUES"
"I want to change my phone number but it says my new one is in use by another customer "	"I do not know how to handle 'I want to change my phone number but it says my new one is in use by another customer '"	"CANONICAL_IDK"
"Can I bring my dog/pet "	"I do not know if you can bring your dog/pet"	"BE_HAVE_MD_QUESTION"
"Do you have a recital each year and are all dancers required to participate "	"I do not know if I have a recital each year and are all dancers required to participate"	"DO_QUESTION"
"What is Estate Recovery "	"I do not know what Estate Recovery is"	"WQUES"
"Who are your reciprocal partners "	"I do not know who my reciprocal partners are"	"WQUES"
"I am having an event . Can I get a donation "	"I do not know if you can get a donation"	"BE_HAVE_MD_QUESTION"
"What do I do if I need special accommodations "	"I do not know what you do if you need special accommodations"	"WQUES"
"What if we need to cancel "	"I do not know what you if need to cancel"	"WQUES"
"Is there a discount for residents "	"I do not know if there is a discount for residents"	"BE_HAVE_MD_QUESTION"
"How do I apply for a position "	"I do not know how you apply for a position"	"WQUES"
"Can I email statements from DanceStudio-Pro "	"I do not know if you can email statements from DanceStudio-Pro"	"BE_HAVE_MD_QUESTION"
"I have followed the booking procedure but I have n't received the voucher , what can I do "	"I do not know what you can do"	"WQUES"
"Will an invoice be included with my order "	"I do not know if an invoice will be included with your order"	"BE_HAVE_MD_QUESTION"
"I want to visit the museum with a group of people ; do you offer a group discount "	"I do not know how to visit the museum with a group of"	"IMPERATIVE"
"Is workplace bullying against the law "	"I do not know if workplace bullying is against the law"	"BE_HAVE_MD_QUESTION"
"I would really appreciate it if you could install the equipment tomorrow seeing as how your tech just totally blew me off today . He did n't even notify me he would n't be coming "	"I do not know how my tech as just totally blew you off today"	"WQUES"
"Can you change my shipping method from Fedex Ground to Fedex Home Delivery so that my package will be delivered on Saturday "	"I do not know if I can change your shipping method from Fedex Ground to Fedex Home Delivery so that your package will be delivered on Saturday"	"BE_HAVE_MD_QUESTION"
"Can you buy tickets online "	"I do not know if I can buy tickets online"	"BE_HAVE_MD_QUESTION"
"I 'm taller than average , do you have a larger version of product "	"I do not know if I have a larger version of product"	"DO_QUESTION"
"When does my Membership arrive "	"I do not know when your Membership arrives"	"WQUES"
"I am interested in applying for clerical/administrative support work . Are there any special requirements "	"I do not know if there are any special requirements"	"BE_HAVE_MD_QUESTION"
"How can I email corporate "	"I do not know how you can email corporate"	"WQUES"
"Once I make a reservation , are there any fees involved if I need to cancel or make changes "	"I do not know if there are any fees involved if you need to cancel or make changes"	"BE_HAVE_MD_QUESTION"
"Can you please reactivate my account "	"I do not know if I can reactivate your account"	"BE_HAVE_MD_QUESTION"
"Can I change the cake flavor for the Wilson wedding on the 29th from vanilla to chocolate with the buttercream frosting "	"I do not know if you can change the cake flavor for the Wilson wedding on the 29th from vanilla to chocolate with the buttercream frosting"	"BE_HAVE_MD_QUESTION"
"Can we bring our own strollers and/or wagons "	"I do not know if you can bring your own strollers and/or wagons"	"BE_HAVE_MD_QUESTION"
"What ages to you teach "	"I do not know what ages to me teach"	"WQUES_SIMPLE"
"How long have we been in this building "	"I do not know how long have you been in this building"	"WQUES_SIMPLE"
"What evidence does an employer need to investigate a claim of harassment "	"I do not know what evidence does an employer need to investigate a claim of harassment"	"WQUES_SIMPLE"
"Do you charge for parking "	"I do not know if I charge for parking"	"DO_QUESTION"
"Do I need to take a drivers ed course "	"I do not know if you need to take a drivers ed course"	"DO_QUESTION"
"Do these soak up water well"	"I do not know if these soak up water well"	"DO_QUESTION"
"For what time periods does Congress.gov have legislative information "	"I do not know for what time periods Congress.gov have legislative information"	"WQUES"
"Are dependents covered under a group health plan eligible for continuation coverage under the Consolidated Omnibus Budget Reconciliation Act -LRB- COBRA -RRB- "	"I do not know if dependents are covered under a group health plan eligible for continuation coverage under the Consolidated Omnibus Budget Reconciliation Act -LRB- COBRA -RRB-"	"BE_HAVE_MD_QUESTION"
"Can I stay with the same partner"	"I do not know if you can stay with the same partner"	"BE_HAVE_MD_QUESTION"
"What do I need to have ready at my school for Zoo on Wheels "	"I do not know what you need to have ready at your school for Zoo on Wheels"	"WQUES"
"What can I do in My Verizon "	"I do not know what you can do in your Verizon"	"WQUES"
"hat are the characteristics of big bucket schedule items "	"I do not know how to handle 'hat are the characteristics of big bucket schedule items '"	"CANONICAL_IDK"
"I never ordered anything last week , but I got a charge "	"I do not know how to handle 'I never ordered anything last week , but I got a charge '"	"CANONICAL_IDK"
"My spouse and I are filing separate returns . How do we split our itemized deductions "	"I do not know how you split your itemized deductions"	"WQUES"
"When I went to the bank last week it was too crowded , I had to give up . Is that possible to make an appointment in advance "	"I do not know when you went to the bank last week"	"WQUES"
"Where 's the nearest restroom and changing station "	"I do not know where the nearest restroom and changing station 's changing station"	"WQUES"
"Can an employer charge any fees to employees who enroll in its paycard program "	"I do not know if an can employer charge any fees to employees who enroll in its paycard program"	"BE_HAVE_MD_QUESTION"
"Do I have to specify the date I am visiting when purchasing tickets online"	"I do not know if you have to specify the date you are visiting when purchasing tickets online"	"DO_QUESTION"
"How does one go about changing the date of a flight to something a bit later ? I do n't need to get there that early"	"I do not know how one goes about changing the date of a flight to something a bit later"	"WQUES_SIMPLE"
"Do you have an expedite process"	"I do not know if I have an expedite process"	"DO_QUESTION"
"How long will it take before I get my check in the mail "	"I do not know how long it will take before you get your check in the mail"	"WQUES"
"What wildlife is there in the National Park "	"I do not know what wildlife is there in the National Park"	"WQUES_SIMPLE"
"Are group discounts available "	"I do not know if group discounts are available"	"BE_HAVE_MD_QUESTION"
"How do I get started with Amazon DynamoDB "	"I do not know how you get started with Amazon DynamoDB"	"WQUES"
"Why do n't your preset answers include -LSB- fill in the blank -RSB- "	"I do not know why my preset answers n't include -LSB- fill in the blank -RSB-"	"WQUES"
"Can you please provide the tracking number for my package "	"I do not know if I can provide the tracking number for your package"	"BE_HAVE_MD_QUESTION"
"I need to fly to columbus , can you tell me what airline to use "	"I do not know what airline to use I fly to columbus , can tell you"	"WQUES"
"I am out of shape . Do I need to lose weight before I try a Barre workout "	"I do not know if you need to lose weight before you try a Barre workout"	"DO_QUESTION"
"Is it easy to learn with the Arthur Murray system of teaching "	"I do not know if it is easy to learn with the Arthur Murray system of teaching"	"BE_HAVE_MD_QUESTION"
"How may an agency implement a schedule item that has a flexible retention period "	"I do not know how an agency may implement a schedule item that has a flexible retention period"	"WQUES"
"Can I put my account on hold for a few months "	"I do not know if you can put your account on hold for a few months"	"BE_HAVE_MD_QUESTION"
"Why do I have to show a photo ID each time I visit "	"I do not know why you have to show a photo ID each time you visit"	"WQUES"
"Will I save money on a 2018 Marketplace plan "	"I do not know if you will save money on a 2018 Marketplace plan"	"BE_HAVE_MD_QUESTION"
"Can I print my own postage or do I need to fill out customs forms at the post office "	"I do not know if you can print your own postage or you need to fill out customs forms at the post office"	"BE_HAVE_MD_QUESTION"
"Do you offer shipping discounts "	"I do not know if I offer shipping discounts"	"DO_QUESTION"
"What do the food & drink vouchers cover "	"I do not know what the food & drink vouchers cover"	"WQUES"
"Does TrueCar sell or service vehicles "	"I do not know if TrueCar sells or service vehicles"	"DO_QUESTION"
"Can you tell me what the difference between this model is and your most expensive model "	"I do not know if I can tell you what the difference between this model is and my most expensive model"	"BE_HAVE_MD_QUESTION"
"If a department wants a wall clock who will pay for it and what is the process of ordering on "	"I do not know what is the process of ordering on a wall clock who will pay for it and what is the process of ordering on will pay for it and"	"WQUES"
"What is the construction happening at the Museum "	"I do not know what the construction happening at the Museum is"	"WQUES"
"What other similar products do you offer "	"I do not know what other similar products I offer"	"WQUES"
"What should I do if I receive a Jury Summons in the mail "	"I do not know what you should do if you receive a Jury Summons in the mail"	"WQUES"
"I am traveling with my family ; can they also use the TSA Pre ✓ ® lane "	"I do not know if they can also use the TSA Pre ✓ ® lane"	"BE_HAVE_MD_QUESTION"
"Why is my job paid differently when compared to another University "	"I do not know why your job is paid differently when compared to another University"	"WQUES"
"Can you tell me what the sale price of your shoes are "	"I do not know if I can tell you what the sale price of my shoes are"	"BE_HAVE_MD_QUESTION"
"Where do I go to change my shipping address "	"I do not know where you go to change your shipping address"	"WQUES"
"Do you offer rentals for moving trucks "	"I do not know if I offer rentals for moving trucks"	"DO_QUESTION"
"What do you consider your ' dance year ' "	"I do not know what I consider my ' dance year '"	"WQUES"
"I am interested in one of your online only sales but I do n't have a credit card . Can I pay with my bank info "	"I do not know if you can pay with your bank info"	"BE_HAVE_MD_QUESTION"
"Can we take pictures in the museum "	"I do not know if you can take pictures in the museum"	"BE_HAVE_MD_QUESTION"
"Do you have a rewards program that I can utilize "	"I do not know if I have a rewards program that you can utilize"	"DO_QUESTION"
"Do schools get discount admission to visit the Zoo "	"I do not know if schools get discount admission to visit the Zoo"	"DO_QUESTION"
"I 'm a Louisville Zoo member . Do I pay a parking fee "	"I do not know if you pay a parking fee"	"DO_QUESTION"
"Are you hiring "	"I do not know if I am hiring"	"BE_HAVE_MD_QUESTION"
"What subscriptions options are available for your service "	"I do not know what subscriptions options are available for my service"	"WQUES_SIMPLE"
"I 'd like to send a special message along with the package "	"I do not know how to send a special message along with the package"	"IMPERATIVE"
"Does the Museum have a cafe "	"I do not know if the Museum has a cafe"	"DO_QUESTION"
"Can I customize my monthly subscription "	"I do not know if you can customize your monthly subscription"	"BE_HAVE_MD_QUESTION"
"I 'm having difficulty deciding which position is the best fit . Is there someone I can speak with to get more information "	"I do not know difficulty deciding which position is the best fit you are having ."	"WQUES"
"What is my monthly payment "	"I do not know what your monthly payment is"	"WQUES"
"Does my theatre offer a student discount "	"I do not know if your theatre offer a student discount"	"DO_QUESTION"
"Do I get to choose where my vehicle is repaired "	"I do not know if you get to choose where your vehicle is repaired"	"DO_QUESTION"
"I have a 30 $ gift card that was included in the family plus and pride level memberships . Is it still valid "	"I do not know a 30 $ gift card that was included in the family plus and pride level memberships you have ."	"WQUES"
"How is Crystal Bridges tied to Walmart "	"I do not know how Crystal Bridges is tied to Walmart"	"WQUES"
"What metrics can be used to determine the effectiveness of succession planning "	"I do not know what metrics to determine the effectiveness of succession planning What metrics can be used"	"WQUES"
"I have a great idea for a show , and would like to work on it with the Center for Puppetry Arts . What do I do "	"I do not know how to and would like to work on it with the Center for Puppetry"	"IMPERATIVE"
"Should I be worried about the noise coming from the back of the rental car ? Is that normal "	"I do not know if you should be worried about the noise coming from the back of the rental car"	"BE_HAVE_MD_QUESTION"
"Why do adults need to pay admission at a children 's museum "	"I do not know why adults need to pay admission at a children 's museum"	"WQUES"
"What time will the parcel be delivered "	"I do not know what time the parcel will be delivered"	"WQUES"
"How can I check the status of my appointment online "	"I do not know how you can check the status of your appointment online"	"WQUES"
"Does ICE 's policy sensitive locations policy remain in effect "	"I do not know if ice 's policy sensitive locations policy remain in effect"	"DO_QUESTION"
"I would like to return an item , but I am not sure if I will have to pay anything for it . Can you help "	"I do not know how to return an"	"IMPERATIVE"
"Is there a way to sign up for job alerts and be notified of future opportunities with Dell "	"I do not know if there is a way to sign up for job alerts and be notified of future opportunities with Dell"	"BE_HAVE_MD_QUESTION"
"If I need to change the person picking up my order , how do I do that "	"I do not know how you do that"	"WQUES"
"My item arrived damaged ! What can I do "	"I do not know what you can do"	"WQUES"
"Can you help me place an order for two rolls "	"I do not know if I can help you place an order for two rolls"	"BE_HAVE_MD_QUESTION"
"Who is eligible for reciprocal admission benefits "	"I do not know who eligible for reciprocal admission benefits is"	"WQUES"
"If an employer is unsure whether an employee gave notice of his or her intent to take Family and Medical Leave Act -LRB- FMLA -RRB- leave , must the employer inquire further "	"I do not know if the employer must inquire further"	"BE_HAVE_MD_QUESTION"
"Is there an ATM at the Court "	"I do not know if there is an ATM at the Court"	"BE_HAVE_MD_QUESTION"
"What is the monthly cost of renting router from your company ? Is the delivery both way included "	"I do not know what the monthly cost of renting router from my company is"	"WQUES"
"Is the Museum devoted exclusively to the art of Eric Carle "	"I do not know if the Museum is devoted exclusively to the art of Eric Carle"	"BE_HAVE_MD_QUESTION"
"This item I ordered is defective and needs to be returned . Can you show me how to return the item "	"I do not know if I can show you how to return the item"	"BE_HAVE_MD_QUESTION"
"Do I need a motorcycle license to ride a scooter or moped "	"I do not know if you need a motorcycle license to ride a scooter or moped"	"DO_QUESTION"
"How can I request for tax exemption on my bill "	"I do not know how you can request for tax exemption on your bill"	"WQUES"
"Who provided input during the creation of the DivX DRM system "	"I do not know who provided input during the creation of the DivX DRM system"	"WSUBJ"
"Is the museum available for event rental or weddings "	"I do not know if the museum is available for event rental or weddings"	"BE_HAVE_MD_QUESTION"
"Is there a grace period for DACA recipients with EADs that will soon expire to make appropriate plans to leave the country "	"I do not know if there is a grace period for DACA recipients with EADs that will soon expire to make appropriate plans to leave the country"	"BE_HAVE_MD_QUESTION"
"What are parabens and why does Beiersdorf use them "	"I do not know why Beiersdorf uses them"	"WQUES"
"I am just wondering if I could change the due date for my bill "	"I do not know how to handle 'I am just wondering if I could change the due date for my bill '"	"CANONICAL_IDK"
"Can I talk to your supervisor about this please "	"I do not know if you can talk to my supervisor about this"	"BE_HAVE_MD_QUESTION"
"How can I be sure that it is the same room type "	"I do not know how can you be sure that it is the same room type"	"WQUES_SIMPLE"
"How do I purchase a gift membership "	"I do not know how you purchase a gift membership"	"WQUES"
"Can we bring our dog to the Zoo "	"I do not know if you can bring your dog to the Zoo"	"BE_HAVE_MD_QUESTION"
"Do we do the challenge as a team or individually "	"I do not know if you do the challenge as a team or individually"	"DO_QUESTION"
"Does the Conservatory offer talent awards "	"I do not know if the Conservatory offer talent awards"	"DO_QUESTION"
"What does Kemppi mean "	"I do not know what Kemppi means"	"WQUES_SIMPLE"
"Can I visit the museum and go to a Pavilion Stage concert on the same day "	"I do not know if you can visit the museum and go to a Pavilion Stage concert on the same day"	"BE_HAVE_MD_QUESTION"
"I ca n't print my tickets at home . What should I do "	"I do not know what you should do"	"WQUES"
"Are you able to accommodate my child with medical allergies and/or special needs "	"I do not know if I am able to accommodate your child with medical allergies and/or special needs"	"BE_HAVE_MD_QUESTION"
"Will I get admitted "	"I do not know if you will get admitted"	"BE_HAVE_MD_QUESTION"
"What if I forget my login info"	"I do not know what you if forget your login info"	"WQUES"
"Do you have many of these items in stock , or will they run out soon "	"I do not know if I have many of these items in stock , or will they run out soon"	"DO_QUESTION"
"What if I have been home schooled "	"I do not know what you if have been home schooled"	"WQUES"
"I will be coming into town this weekend and wanted to stop at your store but you will be closed a couple of minutes earlier than I can get there . Can you stay for a couple of extra minutes to help me out "	"I do not know if I can stay for a couple of extra minutes to help you out"	"BE_HAVE_MD_QUESTION"
"I have lost or misplaced my membership card . How can I request a replacement "	"I do not know how you can request a replacement"	"WQUES"
"Where can I find online coupons"	"I do not know where you can find online coupons"	"WQUES"
"what happens to my resume once I submit it to randstad professionals HR "	"I do not know what happens to your resume once you submit it to randstad professionals HR"	"WSUBJ"
"Are you able to ship outside the United States "	"I do not know if I am able to ship outside the United States"	"BE_HAVE_MD_QUESTION"
"Who do I contact regarding questions "	"I do not know who you contact regarding questions"	"WQUES"
"Does this come in another color "	"I do not know if this comes in another color"	"DO_QUESTION"
"Will I receive a confirmation of my order "	"I do not know if you will receive a confirmation of your order"	"BE_HAVE_MD_QUESTION"
"Is gift packaging available "	"I do not know if gift packaging is available"	"BE_HAVE_MD_QUESTION"
"How will I know if my online application was submitted successfully "	"I do not know how you will know if your online application was submitted successfully"	"WQUES"
"Can my children bring a scooter "	"I do not know if your children can bring a scooter"	"BE_HAVE_MD_QUESTION"
"Why do pets scoot "	"I do not know why pets scoot"	"WQUES"
"I would like to buy a cartoon artwork , do you sell "	"I do not know how to buy a cartoon"	"IMPERATIVE"
"Do I need to speak Japanese "	"I do not know if you need to speak Japanese"	"DO_QUESTION"
"I need to have some work done on my Jeep . Can I schedule an appointment and reserve a loaner for the day "	"I do not know if some have work done on your Jeep ."	"BE_HAVE_MD_QUESTION"
"Can you make sure this package I ordered gets sent to another location ? I recently moved and forgot to update it"	"I do not know if I can make sure this package you ordered gets sent to another location"	"BE_HAVE_MD_QUESTION"
"Do you offer financing "	"I do not know if I offer financing"	"DO_QUESTION"
"Do you guys do gift wrapping "	"I do not know if I guys do gift wrapping"	"DO_QUESTION"
"Why are there so many different labels , some of which are confusing or illegible "	"I do not know why many different labels , some of which are confusing or illegible are there so"	"WQUES"
"Will I receive a phone call or do I have to call you guys "	"I do not know if you will receive a phone call or you have to call I guys"	"BE_HAVE_MD_QUESTION"
"Can I change my award ticket "	"I do not know if you can change your award ticket"	"BE_HAVE_MD_QUESTION"
"I have a ticket without an entry date and time . Will you accept it"	"I do not know if I will accept it"	"BE_HAVE_MD_QUESTION"
"I have not received my item in the mail yet , when should it arrive "	"I do not know when it should arrive"	"WQUES"
"Having issues purchasing tickets online "	"I do not know if issues having purchasing tickets online"	"BE_HAVE_MD_QUESTION"
"When do you guys run your holiday sales "	"I do not know when do I guys run my holiday sales"	"WQUES_SIMPLE"
"Are there some sort of zoning laws or can I build it without a permit "	"I do not know if there are some sort of zoning laws or can you build it without a permit"	"BE_HAVE_MD_QUESTION"
"What is the procedural time limit relating to the applications of the family members of Hungarian citizens and EEA nationals , and for how long the residence card is valid "	"I do not know what the procedural time limit relating to the applications of the family members of Hungarian citizens and EEA nationals is"	"WQUES"
"What is MyChart "	"I do not know what MyChart is"	"WQUES"
"What is the lifetime learning credit "	"I do not know what the lifetime learning credit is"	"WQUES"
"How often do the train rides run "	"I do not know how often the train rides run"	"WQUES"
"What should my application consist of "	"I do not know what your application should consist of"	"WQUES"
"My child is a transfer student with previous dance experience . How do you place her/him in the appropriate level "	"I do not know how I place her/him in the appropriate level"	"WQUES"
"Can I use my gift card online and in store "	"I do not know if you can use your gift card online and in store"	"BE_HAVE_MD_QUESTION"
"What support can I get if I have a problem or any other question "	"I do not know what support you can get if you have a problem or any other question"	"WQUES"
"I 'd like to make an addition to my order and have it shipped with the main item I ordered . How can I do this "	"I do not know how you can do this"	"WQUES"
"What is the difference between Airport transit visa and Transit visa "	"I do not know what the difference between Airport transit visa and Transit visa is"	"WQUES"
"Can you validate that you received my claim "	"I do not know if I can validate that I received your claim"	"BE_HAVE_MD_QUESTION"
"What is your average wait time "	"I do not know what my average wait time is"	"WQUES"
"What should I do in the case of a family status change "	"I do not know what you should do in the case of a family status change"	"WQUES"
"If our new hire wishes to decline our health coverage , can the insurance fees not be automatically withdrawn from her pay "	"I do not know if the insurance fees can not be automatically withdrawn from her pay"	"BE_HAVE_MD_QUESTION"
"Does the court appoint a lawyer to represent me "	"I do not know if the court appoints a lawyer to represent you"	"DO_QUESTION"
"Where can I find support "	"I do not know where you can find support"	"WQUES"
"Can anyone use the collection files for research "	"I do not know if anyone can use the collection files for research"	"BE_HAVE_MD_QUESTION"
"I recently moved to a new city and forgot to change my shipping address . Can I have this package re-routed to my new address "	"I do not know if you can have this package re-routed to your new address"	"BE_HAVE_MD_QUESTION"
"How much do you charge if I would like to locate a vehicle "	"I do not know how much I charge if you would like to locate a vehicle"	"WQUES"
"how do i redeem my travel points "	"I do not know how you redeem your travel points"	"WQUES"
"Can I bring a lunch and eat on the grounds "	"I do not know if you can bring a lunch and eat on the grounds"	"BE_HAVE_MD_QUESTION"
"What do you offer for children throughout the year "	"I do not know what I offer for children throughout the year"	"WQUES"
"I need a copy of a document or a form . Who do I contact "	"I do not know how to a copy of a document or a form ."	"IMPERATIVE"
"What should I do if someone is abusing the chat feature "	"I do not know what you should do if someone is abusing the chat feature"	"WQUES"
"Why do we have to pay full tuition every month "	"I do not know why you have to pay full tuition every month"	"WQUES"
"What kinds of educational activities can I do with my kids/class/camp group "	"I do not know what kinds of educational activities you can do with your kids/class/camp group"	"WQUES"
"I need to check on my walmart order , can you tel me how I do that "	"I do not know how you do that"	"WQUES"
"How does vacation balance transfer to correct absence type for an employee who transfers from one pay group to another -LRB- i.e. from biweekly to monthly ; from union to non-union -RRB- "	"I do not know how does vacation balance transfer to correct absence type for an employee who transfers from one pay group to another -LRB- i.e. from biweekly to monthly ; from union to non-union -RRB-"	"WQUES_SIMPLE"
"How many paid holidays and vacation days do Fairfax County employees receive per year "	"I do not know how many paid holidays and vacation days Fairfax County employees receive per year"	"WQUES_SIMPLE"
"The item I received is damaged . How do I return it and will I be reimbursed "	"I do not know how you return it and will you be reimbursed"	"WQUES"
"Can I find the instructions online "	"I do not know if you can find the instructions online"	"BE_HAVE_MD_QUESTION"
"When is it appropriate to give no increase "	"I do not know when it is appropriate to give no increase"	"WQUES"
"Can you tell me if you can order this in custom colors "	"I do not know if I can tell you if I can order this in custom colors"	"BE_HAVE_MD_QUESTION"
"Where can I see the status of my application "	"I do not know where you can see the status of your application"	"WQUES"
"What is the admission charge "	"I do not know what the admission charge is"	"WQUES"
"Do you offer any type of perks or rewards for being a loyal customer "	"I do not know if I offer any type of perks or rewards for being a loyal customer"	"DO_QUESTION"
"How are applicants with alumni relatives or ' legacies ' handled in Vanderbilt ' s admissions process "	"I do not know how are applicants with alumni relatives or ' legacies ' handled in Vanderbilt ' s admissions process"	"WQUES_SIMPLE"
"How do I change my account information "	"I do not know how you change your account information"	"WQUES"
"What is wearable technology "	"I do not know what wearable technology is"	"WQUES"
"Are there any places to buy a meal or snacks "	"I do not know if there are any places to buy a meal or snacks"	"BE_HAVE_MD_QUESTION"
"May an employer make deductions to an employee 's salary without jeopardizing the employee 's exempt status "	"I do not know if an employer may make deductions to an employee 's salary without jeopardizing the employee 's exempt status"	"BE_HAVE_MD_QUESTION"
"Do we have a restaurant or café and if not what are the nearest ' nice ' places to eat "	"I do not know if you have a restaurant or café and if not what are the nearest ' nice ' places to eat"	"DO_QUESTION"
"Can I register for my wedding here "	"I do not know if you can register for your wedding here"	"BE_HAVE_MD_QUESTION"
"Can you text me when you get this model back in stock "	"I do not know if I can text you when I get this model back in stock"	"BE_HAVE_MD_QUESTION"
"Could you update my email address on your system please , I 've just changed it "	"I do not know if I could update your email address on my system , you 've just changed it"	"BE_HAVE_MD_QUESTION"
"I realized I need my order sooner . How can I change the shipping on my order "	"I do not know how you can change the shipping on your order"	"WQUES"
"The tracking number for my package is incorrect as it shows someone else 's address for the delivery . How can I correct this "	"I do not know how you can correct this"	"WQUES"
"Where are disabled parking spaces located "	"I do not know where disabled parking spaces located are"	"WQUES"
"I 'd like to change my credit card info on my account "	"I do not know how to change your credit card info on your account"	"IMPERATIVE"
"Can I change the address I want the package to be delivered to before it ships out "	"I do not know if you can change the address you want the package to be delivered to before it ships out"	"BE_HAVE_MD_QUESTION"
"Do you have an ATM "	"I do not know if I have an ATM"	"DO_QUESTION"
"What if I do not show up for my award reservation "	"I do not know what you if not show up for your award reservation"	"WQUES"
"Why is jury service important "	"I do not know why is jury service important"	"WQUES_SIMPLE"
"I 'm supposed to bring my cat in tomorrow for shots , but she is seriously stressed , can I reschedule "	"I do not know how to you are supposed to bring your cat in tomorrow for"	"IMPERATIVE"
"What happens if I am selected for the position "	"I do not know what happens if you are selected for the position"	"WSUBJ"
"I recently added a family member to my unlimited family plan , and my bill went up by twenty extra dollars this month . What changed my plan "	"I do not know what changed your plan"	"WSUBJ"
"By what time do I have to order so that the shipment will leave your center the same day "	"I do not know by what time you have to order so that the shipment will leave my center the same day"	"WQUES"
"Is it necessary to go to the Japanese Embassy / Consulate General by myself to apply for a visa "	"I do not know if it is necessary to go to the Japanese Embassy / Consulate General by yourself to apply for a visa"	"BE_HAVE_MD_QUESTION"
"Can I purchase online and have it shipped to the store "	"I do not know if you can purchase online and have it shipped to the store"	"BE_HAVE_MD_QUESTION"
"Can the zoo be rented for special events "	"I do not know if the zoo can be rented for special events"	"BE_HAVE_MD_QUESTION"
"How is the Museum governed "	"I do not know how the Museum is governed"	"WQUES"
"May an employer discipline an employee for off-duty behavior "	"I do not know if an may employer discipline an employee for off-duty behavior"	"BE_HAVE_MD_QUESTION"
"Why was the med-pod only calibrated for male patients when there are several female crewmembers onboard the Prometheus "	"I do not know why the med-pod was only calibrated for male patients when there are several female crewmembers onboard the Prometheus"	"WQUES"
"When I get his socks on , all he does is take them off again . My son is two now ; what can I do "	"I do not know when you get his socks on"	"WQUES"
"I was hoping you could help me with an insurance claim "	"I do not know how to handle 'I was hoping you could help me with an insurance claim '"	"CANONICAL_IDK"
"Who do I need to talk to about getting Sponsored by DXRacer "	"I do not know who you need to talk to about getting Sponsored by DXRacer"	"WQUES"
"Why Do Cats Drool When Petted "	"I do not know why Cats Drool When Petted"	"WQUES_SIMPLE"
"If I have a president 's circle membership or have added a plus one or plus two to my membership , do my guests receive a discount on luminous nights tickets"	"I do not know if your guests receive a discount on luminous nights tickets"	"DO_QUESTION"
"What is DanceSport "	"I do not know what DanceSport is"	"WQUES"
"What 's the cost to ship to NY "	"I do not know what the cost to ship to NY 's"	"WQUES"
"How are departments informed of the results of the criminal background check "	"I do not know how departments informed of the results of the criminal background check are"	"WQUES"
"How do I leave feedback for an order I just made "	"I do not know how you leave feedback for an order you just made"	"WQUES"
"How much for express shipping"	"I do not know how much for express shipping"	"WQUES_SIMPLE"
"What is the phone number to the insurance agency ? I need to call them "	"I do not know what the phone number to the insurance agency is"	"WQUES"
"May I offer an increase in salary for a lateral transfer/hire "	"I do not know if you may offer an increase in salary for a lateral transfer/hire"	"BE_HAVE_MD_QUESTION"
"Can a student make alcohol as part of a science fair project "	"I do not know if a student can make alcohol as part of a science fair project"	"BE_HAVE_MD_QUESTION"
"Does matcha tea have caffeine "	"I do not know if matcha tea has caffeine"	"DO_QUESTION"
"Intel makes processors -- how does that relate to software "	"I do not know how that relates to software"	"WQUES"
"Do any large whales have teeth "	"I do not know if any large whales have teeth"	"DO_QUESTION"
"I had my order shipped to my home but I want to pick it up instead , how do I do this "	"I do not know how you do this"	"WQUES"
"Are there video screens"	"I do not know if there are video screens"	"BE_HAVE_MD_QUESTION"
"Could you please tell me how much I owe "	"I do not know if I could tell you how much you owe"	"BE_HAVE_MD_QUESTION"
"Can I make an appointment to get an oil change "	"I do not know if you can make an appointment to get an oil change"	"BE_HAVE_MD_QUESTION"
"When prompted , should I ' Open ' or ' Save As ' my purchased video "	"I do not know when prompted you ' Open ' or ' , should Save As ' your purchased video"	"WQUES"
"What is the best time to reach technical care "	"I do not know what the best time to reach technical care is"	"WQUES"
"Can you help if I 've lost my card and need help reordering "	"I do not know if I can help if you 've lost your card and need help reordering"	"BE_HAVE_MD_QUESTION"
"When will my order arrive "	"I do not know when your order will arrive"	"WQUES"
"Can I still purchase tickets at the gate if the event sells out in advance "	"I do not know if you can still purchase tickets at the gate if the event sells out in advance"	"BE_HAVE_MD_QUESTION"
"Can I bring my own food/picnic "	"I do not know if you can bring your own food/picnic"	"BE_HAVE_MD_QUESTION"
"Does the drone fly over 100 feet high"	"I do not know if the drone fly over 100 feet high"	"DO_QUESTION"
"Why is Lodge Enamel Made in China "	"I do not know why Lodge Enamel is Made in China"	"WQUES"
"Can I book flights for multiple-stop itineraries online "	"I do not know if you can book flights for multiple-stop itineraries online"	"BE_HAVE_MD_QUESTION"
"Do you have the number of the shipper "	"I do not know if I have the number of the shipper"	"DO_QUESTION"
"What if I have trouble using your online ticketing "	"I do not know what you if have trouble using my online ticketing"	"WQUES"
"I was given these tickets as a gift , but the person who gifted them has passed away . How do I get the tickets "	"I do not know the person who gifted them has passed away you were given these tickets as a gift , but ."	"WQUES"
"If I want my product here by Friday , which shipping method should I select "	"I do not know by Friday , which shipping method should you select you If want your product here"	"WQUES"
"How do I view the video tutorials "	"I do not know how you view the video tutorials"	"WQUES"
"Will I be able to return my item to a store or do I have to ship it back "	"I do not know if you will be able to return your item to a store or you have to ship it back"	"BE_HAVE_MD_QUESTION"
"Can I bring food and drinks to the Zoo "	"I do not know if you can bring food and drinks to the Zoo"	"BE_HAVE_MD_QUESTION"
"Do my children require US passports "	"I do not know if your children require you passports"	"DO_QUESTION"
"What programming is available for school groups "	"I do not know what programming is available for school groups"	"WQUES_SIMPLE"
"What is the cost of the renter 's insurance if I live in gated apartment complex ? Is there any discount "	"I do not know what the cost of the renter 's insurance is"	"WQUES"
"What information do I have to provide to become an UMMA Free Member "	"I do not know what information you have to provide to become an UMMA Free Member"	"WQUES"
"Can I have a party in my room "	"I do not know if you can have a party in your room"	"BE_HAVE_MD_QUESTION"
"How do I play Switch Zoo "	"I do not know how you play Switch Zoo"	"WQUES"
"I want to upgrade my phone plan and I need to find out more better deals "	"I do not know how to handle 'I want to upgrade my phone plan and I need to find out more better deals '"	"CANONICAL_IDK"
"What can I use for user name "	"I do not know what you can use for user name"	"WQUES"
"At what temperature should I heat my water in a Staub teapot "	"I do not know at what temperature you should heat your water in a Staub teapot"	"WQUES"
"I need to change my address on my last order , can you tell me how to do this "	"I do not know how you to do this"	"WQUES"
"My packaged needs to be signed for but I wo n't be there on the delivery date . Can I leave a signed note with a friend and have them present it to the delivery person "	"I do not know if you can leave a signed note with a friend and have them present it to the delivery person"	"BE_HAVE_MD_QUESTION"
"What do your contracts look like "	"I do not know what my contracts look like"	"WQUES"
"When I try to set up a new password for My Verizon , I get a message saying it 's not valid because it 's an easily guessed password . What does this mean "	"I do not know when you try to set up a new password for your Verizon"	"WQUES"
"Where can I find growing instructions for these roses "	"I do not know where you can find growing instructions for these roses"	"WQUES"
"Is an employer required to accommodate an employee 's or applicant 's family responsibilities "	"I do not know if an employer is required to accommodate an employee 's or applicant 's family responsibilities"	"BE_HAVE_MD_QUESTION"
"Can my kids visit the museums without me "	"I do not know if your kids can visit the museums without you"	"BE_HAVE_MD_QUESTION"
"How long have I been a costumer here "	"I do not know how long have you been a costumer here"	"WQUES_SIMPLE"
"Does the Subaru Certified Pre-Owned program have a deductible "	"I do not know if the Subaru Certified Pre-Owned program has a deductible"	"DO_QUESTION"
"I bought one of your digital products but I lost the product code , can you help me recover it "	"I do not know if I can help you recover it"	"BE_HAVE_MD_QUESTION"
"I accidentally purchased the wrong TV mount and destroyed the box . Is it possible that I could get a refund still "	"I do not know if it is possible that you could get a refund still"	"BE_HAVE_MD_QUESTION"
"Am I allowed to bring food into the zoo"	"I do not know if you are allowed to bring food into the zoo"	"BE_HAVE_MD_QUESTION"
"How long does it take to see everything"	"I do not know how long it takes to see everything"	"WQUES"
"Are n't dance classes expensive "	"I do not know if n't are dance classes expensive"	"BE_HAVE_MD_QUESTION"
"I just bought a fan from your site and it 's making a tick tick ticking noise that just wo n't stop "	"I do not know it 's making a tick tick ticking noise that just wo n't stop you just bought a fan from my site and"	"WQUES"
"Can you tell me the name of the service agent that specializes in this situation "	"I do not know if I can tell you the name of the service agent that specializes in this situation"	"BE_HAVE_MD_QUESTION"
"Can I change my shipping speed after purchase "	"I do not know if you can change your shipping speed after purchase"	"BE_HAVE_MD_QUESTION"
"What browsers are supported "	"I do not know what browsers are supported"	"WQUES_SIMPLE"
"What is the quickest way to get my money back on a return ? Should I send it first class or overnight mail "	"I do not know what the quickest way to get your money on a return is back on a return"	"WQUES"
"I submitted an order for a yellow blouse , but my email confirmation mentions blue - can we check on the color to make sure it 's correct before it 's shipped "	"I do not know if you can check on the color to make sure it 's correct before it 's shipped"	"BE_HAVE_MD_QUESTION"
"Why have n't you charged my credit card yet "	"I do not know why I have n't charged your credit card yet"	"WQUES"
"I 'm going to be out of town next week - can you cancel my order for just that week "	"I do not know if I can cancel your order for just that week"	"BE_HAVE_MD_QUESTION"
"Can you tell me if this particular necklace is on backorder or if I should just look elsewhere "	"I do not know if I can tell you if this particular necklace is on backorder or if you should just look elsewhere"	"BE_HAVE_MD_QUESTION"
"I just got my shirt in the mail and it is the wrong size and color . How do I go about getting the correct item and you guys will pay for the return right "	"I do not know how you go about getting the correct item and I guys will pay for the return right"	"WQUES"
"Can I take an earlier tour if I arrive early "	"I do not know if you can take an earlier tour if you arrive early"	"BE_HAVE_MD_QUESTION"
"Can my child attend Camp with a friend "	"I do not know if your child can attend Camp with a friend"	"BE_HAVE_MD_QUESTION"
"What are the different types of employee awards and employee recognitions "	"I do not know what the different types of employee awards and employee recognitions are"	"WQUES"
"Can I sleep next to my partner or friend "	"I do not know if you can sleep next to your partner or friend"	"BE_HAVE_MD_QUESTION"
"Hello . I would like to buy a new insurance but can you tell me whether any of your plans are a better deal than what I already have "	"I do not know how to hello ."	"IMPERATIVE"
"What is in the Museums permanent collection "	"I do not know what is in the Museums permanent collection"	"WSUBJ"
"What types of people are selected as Fellows "	"I do not know what types of people are selected as Fellows"	"WQUES_SIMPLE"
"I have an item I want to exchange but I have no idea if I can exchange it because I received it as a gift "	"I do not know how to handle 'I have an item I want to exchange but I have no idea if I can exchange it because I received it as a gift '"	"CANONICAL_IDK"
"Can I choose when I receive the subscription box "	"I do not know if you can choose when you receive the subscription box"	"BE_HAVE_MD_QUESTION"
"When will my debit card arrive in the mail "	"I do not know when your debit card will arrive in the mail"	"WQUES"
"Can you tell me if you have special accounts designed for students at your bank "	"I do not know if I can tell you if I have special accounts designed for students at my bank"	"BE_HAVE_MD_QUESTION"
"What are the monthly access charges for smartphones , tablets and mobile hotspots on the Verizon Plan , and why are some of them different "	"I do not know what the monthly access charges for smartphones , tablets and mobile hotspots on the Verizon Plan are"	"WQUES"
"What file format are the templates offered in "	"I do not know what file format are the templates offered in"	"WQUES_SIMPLE"
"Can you check if I qualify for the program "	"I do not know if I can check if you qualify for the program"	"BE_HAVE_MD_QUESTION"
"What will your beginner learn"	"I do not know what my beginner will learn"	"WQUES"
"Does your store have a plus size department "	"I do not know if my store have a plus size department"	"DO_QUESTION"
"How many people were registered as prisoners in Auschwitz "	"I do not know how many people were registered as prisoners in Auschwitz"	"WQUES_SIMPLE"
"Could you please check my account ? I am concerned about a deposit I made . It is not showing on my statement "	"I do not know if I could check your account"	"BE_HAVE_MD_QUESTION"
"How does TrueCar use information about me "	"I do not know how TrueCar uses information about you"	"WQUES"
"I had ordered check books some time ago . But I had not received them . Can you check the status for me "	"I do not know if I can check the status for you"	"BE_HAVE_MD_QUESTION"
"What is Pacific known for "	"I do not know what is Pacific known for"	"WQUES"
"What are the qualifications of your teaching staff "	"I do not know what the qualifications of my teaching staff are"	"WQUES"
"What does your beginner need to dance"	"I do not know what does my beginner need to dance"	"WQUES_SIMPLE"
"How many problems does the student complete in each lesson "	"I do not know how many problems does the student complete in each lesson"	"WQUES_SIMPLE"
"Do you have any foundation suitable for oily skin "	"I do not know if I have any foundation suitable for oily skin"	"DO_QUESTION"
"I am ready to learn ! How do I get started "	"I do not know how you get started"	"WQUES"
"Why is the shipping fee $ 32 "	"I do not know why the shipping fee $ 32 is"	"WQUES"
"What kind of airplanes do you have at the Air Museum "	"I do not know what kind of airplanes I have at the Air Museum"	"WQUES"
"Can I add tip to the receipt or should I pay the tip in cash "	"I do not know if you can add tip to the receipt or should you pay the tip in cash"	"BE_HAVE_MD_QUESTION"
"What is a Barre Workout "	"I do not know what a Barre Workout is"	"WQUES"
"Where can I park when coming for a tour "	"I do not know where you can park when coming for a tour"	"WQUES"
"Where on the website can I find rentals for medical equipment "	"I do not know where on the website you can find rentals for medical equipment"	"WQUES"
"I was n't able to locate the tracking number on this order , could you please look that up for me "	"I do not know if I could look that up for you"	"BE_HAVE_MD_QUESTION"
"Can I schedule a maintenance appointment "	"I do not know if you can schedule a maintenance appointment"	"BE_HAVE_MD_QUESTION"
"How do I communicate with my account manager or request IT advice "	"I do not know how you communicate with your account manager or request IT advice"	"WQUES"
"What kind of works do you have in your permanent collection "	"I do not know what kind of works I have in my permanent collection"	"WQUES"
"I have been looking in to getting auto insurance , can you tell me if there are different insurance coverage types "	"I do not know if I can tell you if there are different insurance coverage types"	"BE_HAVE_MD_QUESTION"
"When can I check into my room "	"I do not know when you can check into your room"	"WQUES"
"My keys will not work for my apartment , is the office still open so i can get another one "	"I do not know if the office is still open so you can get another one"	"BE_HAVE_MD_QUESTION"
"Do I really need an employee handbook"	"I do not know if you really need an employee handbook"	"DO_QUESTION"
"Does Kirkland 's have a catalog "	"I do not know if Kirkland 's have a catalog"	"DO_QUESTION"
"Is there a grace period for late payments "	"I do not know if there is a grace period for late payments"	"BE_HAVE_MD_QUESTION"
"What if I 'm visiting another zoo or aquarium "	"I do not know what you if 'm visiting another zoo or aquarium"	"WQUES"
"How can I get photographic prints or slides of Museum images "	"I do not know how you can get photographic prints or slides of Museum images"	"WQUES"
"What are the pros and cons of allowing e-cigarettes in the workplace "	"I do not know what the pros and cons of allowing e-cigarettes in the workplace are"	"WQUES"
"Do you guarantee that we will see whales on the whale watching excursion "	"I do not know if I guarantee that you will see whales on the whale watching excursion"	"DO_QUESTION"
"Who should write my letter of recommendation "	"I do not know who should write your letter of recommendation"	"WSUBJ"
"I would like to withdraw cash from my account "	"I do not know how to withdraw cash from your account"	"IMPERATIVE"
"What if the student 's and teacher 's personalities do n't mesh well or the student is dissatisfied "	"I do not know what the student 's and teacher 's personalities if n't mesh well or the student is dissatisfied"	"WQUES"
"Do people like working at Bamboo "	"I do not know if people like working at Bamboo"	"DO_QUESTION"
"Can you help check on my order "	"I do not know if I can help check on your order"	"BE_HAVE_MD_QUESTION"
"What is DivX Certified Device Registration "	"I do not know what DivX Certified Device Registration is"	"WQUES"
"Does BAMPFA offer art and film appraisal services "	"I do not know if bampfa offer art and film appraisal services"	"DO_QUESTION"
"What if my question is not answered on this page "	"I do not know what your question if is not answered on this page"	"WQUES"
"I need to book a hotel for labor day weekend , I know this is short notice but are there any opening "	"I do not know how to book a hotel for labor day"	"IMPERATIVE"
"Will dinner or breakfast be served "	"I do not know if dinner or breakfast will be served"	"BE_HAVE_MD_QUESTION"
"How much is my order total "	"I do not know how much your order is total"	"WQUES"
"Who should I contact about my tax query "	"I do not know who you should contact about your tax query"	"WQUES"
"What kinds of transportation fringe benefits may an employer offer its employees on a tax-free basis "	"I do not know what kinds of transportation fringe benefits may an employer offer its employees on a tax-free basis"	"WQUES_SIMPLE"
"If a candidate is found ineligible for employment based on the results of the background check , who may the department contact for further information "	"I do not know based on the results of the background check , who may the department contact for further information a candidate If is found ineligible for employment"	"WQUES"
"What is your companies website "	"I do not know what is my companies website"	"WQUES_SIMPLE"
"How long after I receive a product do I have to return it "	"I do not know how long after you receive a product you have to return it"	"WQUES_SIMPLE"
"What if I do n't know the exact page of the census "	"I do not know what you if n't know the exact page of the census"	"WQUES"
"How much sex , violence , and profanity are in this movie "	"I do not know how much sex , violence , and profanity violence profanity are in this movie"	"WQUES"
"I placed an order last week , and it was scheduled to be delivered today . I checked my order status online and now it says it is on back order , can you please help me find out how it went from out for delivery to back-ordered status "	"I do not know how to and it was scheduled to be delivered"	"IMPERATIVE"
"Could you take our appetizer off of our bill "	"I do not know if I could take your appetizer off of your bill"	"BE_HAVE_MD_QUESTION"
"It 's urgent that I get this package tomorrow morning "	"I do not know how to handle 'It 's urgent that I get this package tomorrow morning '"	"CANONICAL_IDK"
"If I am not a united.com Club member and I purchase the ticket for someone who is a united.com Club member , do they get the credit "	"I do not know for someone who is a united.com Club you purchase the ticket"	"WQUES"
"I want to know what the cheapest offers are for flights to San Diego next month "	"I do not know what the cheapest offers are for flights to San Diego next month"	"WQUES_SIMPLE"
"Where can I enter the Museum for evening programs and lectures "	"I do not know where you can enter the Museum for evening programs and lectures"	"WQUES"
"Is there an estimated time that goods typically arrive "	"I do not know if there is an estimated time that goods typically arrive"	"BE_HAVE_MD_QUESTION"
"How does ED define a ' comparable program of study ' when considering eligibility for a closed school loan discharge "	"I do not know how ED defines a ' comparable program of study ' when considering eligibility for a closed school loan discharge"	"WQUES"
"Can you help me find a job"	"I do not know if I can help you find a job"	"BE_HAVE_MD_QUESTION"
"At which location will I be working "	"I do not know at which location you will be working"	"WQUES"
"Are there any days the museum is free admission "	"I do not know if there are any days the museum is free admission"	"BE_HAVE_MD_QUESTION"
"What do I wear to my first visit "	"I do not know what you wear to your first visit"	"WQUES"
"Can you please check on my package "	"I do not know if I can check on your package"	"BE_HAVE_MD_QUESTION"
"What about a capsule hotel "	"I do not know what about a capsule hotel"	"WQUES_SIMPLE"
"Is there any trade-in program that gives a discount on new purchases "	"I do not know if there is any trade-in program that gives a discount on new purchases"	"BE_HAVE_MD_QUESTION"
"What are the private lessons "	"I do not know what the private lessons are"	"WQUES"
"Does your restaurant offer any vegan options "	"I do not know if my restaurant offer any vegan options"	"DO_QUESTION"
"I do n't have any children but I am a kid at heart , can I come and enjoy the museum "	"I do not know if you can come and enjoy the museum"	"BE_HAVE_MD_QUESTION"
"I would like to know what your refund policy is "	"I do not know what my refund policy is"	"WQUES_SIMPLE"
"Do you have parking facilities "	"I do not know if I have parking facilities"	"DO_QUESTION"
"Can I change my due date "	"I do not know if you can change your due date"	"BE_HAVE_MD_QUESTION"
"What if I have questions about using ESS or wish to offer some feedback "	"I do not know what you if have questions about using ESS or wish to offer some feedback"	"WQUES"
"I need to change the answers to my security questions on my account , please "	"I do not know how to change the answers to your security questions on your account"	"IMPERATIVE"
"If I sign up for ticket for an event , what should I keep in mind "	"I do not know what you should keep in mind"	"WQUES"
"Are DivX Certified devices required to support DivX DRM "	"I do not know if divx are Certified devices required to support DivX DRM"	"BE_HAVE_MD_QUESTION"
"Do I need to be home to sign for my package "	"I do not know if you need to be home to sign for your package"	"DO_QUESTION"
"I missed my flight , Could you please change my hotel reservation to match my new itinerary "	"I do not know if I could change your hotel reservation to match your new itinerary"	"BE_HAVE_MD_QUESTION"
"I 'm waiting for a sale , are there any coming up "	"I do not know if there are any coming up"	"BE_HAVE_MD_QUESTION"
"What does ' Benefits Eligible ' mean "	"I do not know what does ' Benefits Eligible ' mean"	"WSUBJ"
"When I received my package today , one of the items was broken . May I get a replacement sent to me "	"I do not know when you received your package today"	"WQUES"
"Why is my order arriving in multiple packages "	"I do not know why your order is arriving in multiple packages"	"WQUES"
"I ordered the wrong size and I 'd like to cancel my order "	"I do not know how to handle 'I ordered the wrong size and I 'd like to cancel my order '"	"CANONICAL_IDK"
"What is the difference between ' document ' and ' non-document ' or ' product ' shipments for international shipping "	"I do not know what the difference between ' document ' and ' non-document ' or ' product ' shipments for international shipping is"	"WQUES"
"Can we leave and come back "	"I do not know if you can leave and come back"	"BE_HAVE_MD_QUESTION"
"How soon can customer service get here "	"I do not know how soon customer service can get here"	"WQUES"
"I accidentally placed an order on the site and I was n't done shopping , how do I cancel it "	"I do not know how you cancel it"	"WQUES"
"Is there parking at your location"	"I do not know if there is parking at my location"	"BE_HAVE_MD_QUESTION"
"Is BPA found in your PET plastic bottles "	"I do not know if BPA is found in my PET plastic bottles"	"BE_HAVE_MD_QUESTION"
"In terms of giving a gift , what is the difference between the new , renew and Gift Options"	"I do not know what the difference between the new , renew and Gift Options is"	"WQUES"
"Can I change the font of the print view for Book "	"I do not know if you can change the font of the print view for Book"	"BE_HAVE_MD_QUESTION"
"What are the OSU Museum of Art Advocates "	"I do not know what the OSU Museum of Art Advocates are"	"WQUES"
"Can I purchase a Community Value membership on a blackout date "	"I do not know if you can purchase a Community Value membership on a blackout date"	"BE_HAVE_MD_QUESTION"
"Can Zookeepers go into areas with the animals "	"I do not know if zookeepers can go into areas with the animals"	"BE_HAVE_MD_QUESTION"
"Can I change my subscription "	"I do not know if you can change your subscription"	"BE_HAVE_MD_QUESTION"
"What 's your refund policy "	"I do not know what my refund policy 's"	"WQUES"
"Can the walker be the same person each day , so my dog gets used to him/her "	"I do not know if the walker can be the same person each day , so your dog gets used to him/her"	"BE_HAVE_MD_QUESTION"
"When is the payment due "	"I do not know when the payment is due"	"WQUES"
"Why does it take so long to complete the hire process "	"I do not know why it takes so long to complete the hire process"	"WQUES"
"If I submitted my order before I used the promo code , can I still have the promo code applied "	"I do not know if you can still have the promo code applied"	"BE_HAVE_MD_QUESTION"
"How do you make a contribution to reduce the debt "	"I do not know how I make a contribution to reduce the debt"	"WQUES"
"Will you accept an application after the closing date "	"I do not know if I will accept an application after the closing date"	"BE_HAVE_MD_QUESTION"
"How much is daily admission "	"I do not know how much daily admission is"	"WQUES"
"I am having trouble logging in online . Can you reset my password or do I need to talk to someone else "	"I do not know if I can reset your password or you need to talk to someone else"	"BE_HAVE_MD_QUESTION"
"I recently moved , do I need to change my address with Benefits for my insurance "	"I do not know how to you recently"	"IMPERATIVE"
"Is my eye glass prescription still on file "	"I do not know if your eye glass prescription is still on file"	"BE_HAVE_MD_QUESTION"
"Do you offer gift wrapping "	"I do not know if I offer gift wrapping"	"DO_QUESTION"
"I just renewed my membership . What are my benefits now "	"I do not know what your benefits are"	"WQUES"
"Where can I find more information about this company "	"I do not know where you can find more information about this company"	"WQUES"
"Can this item be returned once the box has been opened "	"I do not know if this item can be returned once the box has been opened"	"BE_HAVE_MD_QUESTION"
"Can I bring pets or other animals to the BioPark "	"I do not know if you can bring pets or other animals to the BioPark"	"BE_HAVE_MD_QUESTION"
"How do I recognize the play money poker tables "	"I do not know how you recognize the play money poker tables"	"WQUES"
"Help me locate the product recalls section on your website "	"I do not know how to handle 'Help me locate the product recalls section on your website '"	"CANONICAL_IDK"
"What times do the tour buses leave "	"I do not know what times the tour buses leave"	"WQUES"
"Why are there different versions of bills "	"I do not know why different versions of bills are there"	"WQUES"
"What are your delivery times "	"I do not know what my delivery times are"	"WQUES"
"Can I remove the credit link ' Joomla Templates by ZooTemplate.Com ' "	"I do not know if you can remove the credit link ' Joomla Templates by ZooTemplate.Com '"	"BE_HAVE_MD_QUESTION"
"How do I put an item on layaway "	"I do not know how you put an item on layaway"	"WQUES"
"Do I need to purchase extra insurance "	"I do not know if you need to purchase extra insurance"	"DO_QUESTION"
"How much might the Occupational Safety and Health Administration -LRB- OSHA -RRB- make an employer pay if it receives an OSHA citation "	"I do not know how much the Occupational Safety and Health Administration -LRB- OSHA -RRB- might Health Administration -LRB- OSHA -RRB- make an employer pay if it receives an OSHA citation"	"WQUES"
"Can my relatives or friends who do not live in my household be included on my membership card "	"I do not know if your relatives or friends who can not live in your household be included on your membership card"	"BE_HAVE_MD_QUESTION"
"Can I get an account on credit "	"I do not know if you can get an account on credit"	"BE_HAVE_MD_QUESTION"
"Please stop sending me catalogs "	"I do not know how to stop sending you catalogs"	"IMPERATIVE"
"What products are popular in my area "	"I do not know what products are popular in your area"	"WQUES_SIMPLE"
"do you know when the next version of this phone will be released "	"I do not know if I know when the next version of this phone will be released"	"DO_QUESTION"
"What fish species do you study at the NEFSC "	"I do not know what fish species I study at the NEFSC"	"WQUES"
"How are supporting documents -LRB- transcripts and teacher recommendations -RRB- submitted as part of my Coalition Application "	"I do not know how are supporting documents -LRB- transcripts and teacher recommendations -RRB- submitted as part of your Coalition Application"	"WQUES_SIMPLE"
"Can Grandparents claim grandchildren "	"I do not know if grandparents can claim grandchildren"	"BE_HAVE_MD_QUESTION"
"What is OnStar ® "	"I do not know what OnStar ® is"	"WQUES"
"What steps can an employer take to reduce the risk of exposure of the Zika virus in the workplace "	"I do not know what steps an employer can take to reduce the risk of exposure of the Zika virus in the workplace"	"WQUES"
"If I buy a Guided Tour for the Vatican Gardens , is it possible to see the Vatican Museums with the same ticket "	"I do not know if it is possible to see the Vatican Museums with the same ticket"	"BE_HAVE_MD_QUESTION"
"Can I pay visa issuance fees with a credit card or a check "	"I do not know if you can pay visa issuance fees with a credit card or a check"	"BE_HAVE_MD_QUESTION"
"I specifically informed the waiter of my peanut allergy , but this entree includes visible peanuts in the sauce and I would like to return it "	"I do not know how to handle 'I specifically informed the waiter of my peanut allergy , but this entree includes visible peanuts in the sauce and I would like to return it '"	"CANONICAL_IDK"
"After I learn to dance , will I still have to return to learn the newest steps "	"I do not know if you will still have to return to learn the newest steps"	"BE_HAVE_MD_QUESTION"
"How long does the sign up process take "	"I do not know how long does the sign up process take"	"WQUES_SIMPLE"
"Can I get some extra padding for this new shipment "	"I do not know if you can get some extra padding for this new shipment"	"BE_HAVE_MD_QUESTION"
"How much is my deductible "	"I do not know how much your deductible is"	"WQUES"
"Can you assist with a new order "	"I do not know if I can assist with a new order"	"BE_HAVE_MD_QUESTION"
"Can my children visit the museum with a family caregiver "	"I do not know if your children can visit the museum with a family caregiver"	"BE_HAVE_MD_QUESTION"
"Can you adjust some things made on my order "	"I do not know if I can adjust some things made on your order"	"BE_HAVE_MD_QUESTION"
"I would like some things removed from the order I just made "	"I do not know how to handle 'I would like some things removed from the order I just made '"	"CANONICAL_IDK"
"Are service animals allowed at the Zoo "	"I do not know if service animals are allowed at the Zoo"	"BE_HAVE_MD_QUESTION"
"I 've been locked out of my account , what now "	"I do not know what now you 've been locked out of your account ,"	"WQUES"
"Can I do work experience at the zoo "	"I do not know if you can work experience at the zoo"	"BE_HAVE_MD_QUESTION"
"How long is it until my subscription expires "	"I do not know how long it is until your subscription expires"	"WQUES"
"Does the monthly tuition fee remain the same each month "	"I do not know if the monthly tuition fee remains the same each month"	"DO_QUESTION"
"What 's the charge for overnight shipping "	"I do not know what the charge for overnight shipping 's"	"WQUES"
"Where can I find a detailed list of the nutritional information about each of the components of the meals on your delivery menu "	"I do not know where you can find a detailed list of the nutritional information about each of the components of the meals on my delivery menu"	"WQUES"
"What are the Federal and State excise taxes rates for spirits , wine and beer "	"I do not know what the Federal and State excise taxes rates for spirits , wine and beer are"	"WQUES"
"Should I wear shoes "	"I do not know if you should wear shoes"	"BE_HAVE_MD_QUESTION"
"Who in Personnel should I contact about my appointment "	"I do not know who in Personnel you should contact about your appointment"	"WQUES"
"How can I lower my monthly payments "	"I do not know how you can lower your monthly payments"	"WQUES"
"How can I recycle used consumables "	"I do not know how you can recycle used consumables"	"WQUES"
"Can I take a bus to the Hospital "	"I do not know if you can take a bus to the Hospital"	"BE_HAVE_MD_QUESTION"
"Who are the teachers "	"I do not know who the teachers are"	"WQUES"
"How can I avoid being attacked by a shark "	"I do not know how you can avoid being attacked by a shark"	"WQUES"
"Are there restrictions on what sort of items I can bring into the Maritime Research Center "	"I do not know if there are restrictions on what sort of items you can bring into the Maritime Research Center"	"BE_HAVE_MD_QUESTION"
"I saw you released a new model , how is it different from the old version "	"I do not know how is it different from the old version you saw I released a new model ,"	"WQUES"
"What is the Crocker Art Museum Association "	"I do not know what the Crocker Art Museum Association is"	"WQUES"
"Can you tell me what ingredients in this product can set off an allergic reaction "	"I do not know if I can tell you what ingredients in this product can set off an allergic reaction"	"BE_HAVE_MD_QUESTION"
"Do you mind if I eat a competitors product in your store as long as I buy some of your product too so I can compare them "	"I do not know if I mind if you eat a competitors product in my store as long as you buy some of my product too so you can compare them"	"DO_QUESTION"
"I seem to be missing one item from my order that I placed last week , how do I get this mistake corrected "	"I do not know how you do get this mistake corrected"	"WQUES"
"I will not be home for delivery . Can you re-route the package to a different address "	"I do not know if I can re-route the package to a different address"	"BE_HAVE_MD_QUESTION"
"I received towels I ordered . They were thinner than I thought . Can you recommend different brands "	"I do not know if I can recommend different brands"	"BE_HAVE_MD_QUESTION"
"My old passport has already expired . My visa to travel to the United States is still valid but in my expired passport . Do I need to apply for a new visa with my new passport "	"I do not know if you need to apply for a new visa with your new passport"	"DO_QUESTION"
"Will the store be open on Easter "	"I do not know if the store will be open on Easter"	"BE_HAVE_MD_QUESTION"
"I 'd like to make sure this package arrives at a specific time , can you help me out here "	"I do not know if I can help you out here"	"BE_HAVE_MD_QUESTION"
"Do provisions of the federal tax law such as section 66 -LRB- treatment of community income -RRB- and section 469 -LRB- i -RRB- -LRB- 5 -RRB- -LRB- $ 25,000 offset for passive activity losses for rental real estate activities -RRB- that apply to married taxpayers apply to registered domestic partners "	"I do not know if provisions of the federal tax law such as section 66 -LRB- treatment of community income -RRB- and section 469 -LRB- you -RRB- -LRB- 5 -RRB- -LRB- $ 25,000 offset for passive activity losses for rental real estate activities -RRB- that apply to married taxpayers apply to registered domestic partners"	"DO_QUESTION"
"I lost the warranty for my item but it broke within two weeks , which would have been covered under the warranty . Can I do anything to verify this warranty and receive a new item "	"I do not know it broke within two weeks , which would have been covered under the warranty you lost the warranty for your item but ."	"WQUES"
"How many employees are in the National Park Service "	"I do not know how many employees are in the National Park Service"	"WQUES_SIMPLE"
"How can I be involved with the Simeone Museum"	"I do not know how you can be involved with the Simeone Museum"	"WQUES"
"What levels/phases do you teach "	"I do not know what levels/phases I teach"	"WQUES"
"What is the balance in my account "	"I do not know what the balance in your account is"	"WQUES"
"What type of service do you do to the cars before selling them "	"I do not know what type of service I do to the cars before selling them"	"WQUES"
"How does a group plan its visit "	"I do not know how does a group plan its visit"	"WQUES_SIMPLE"
"How can I get to The Field Museum by public transport "	"I do not know how you can get to The Field Museum by public transport"	"WQUES"
"How long does it take to go through the Museum "	"I do not know how long it takes to go through the Museum"	"WQUES"
"Shipping in 2 days is guaranteed but does that include delivery on a weekend day "	"I do not know shipping in 2 days is guaranteed but that includes delivery on a weekend day"	"WSUBJ"
"Can I use multiple coupons "	"I do not know if you can use multiple coupons"	"BE_HAVE_MD_QUESTION"
"I placed an order 2 weeks ago and I have n't received it yet , could you please check it"	"I do not know if I could check it"	"BE_HAVE_MD_QUESTION"
"How can I learn about import or export licensing "	"I do not know how you can learn about import or export licensing"	"WQUES"
"Is it possible to put my subscription on hold for a few months "	"I do not know if it is possible to put your subscription on hold for a few months"	"BE_HAVE_MD_QUESTION"
"Can you help me find a suitable carseat "	"I do not know if I can help you find a suitable carseat"	"BE_HAVE_MD_QUESTION"
"What Time is Check-In / Check-Out "	"I do not know what Time is Check-In / Check-Out"	"WQUES_SIMPLE"
"Why is admission being increased "	"I do not know why admission is being increased"	"WQUES"
"Can I modify the source code "	"I do not know if you can modify the source code"	"BE_HAVE_MD_QUESTION"
"I want to reschedule my vacation ; there was a recent death in the family . I know I paid for the insurance plan , so what happens now "	"I do not know how to reschedule your"	"IMPERATIVE"
"What happens after I submit my application for a position "	"I do not know what happens after you submit your application for a position"	"WSUBJ"
"How do elected officials and public access officers certify they have completed the training "	"I do not know how elected officials and public access officers public access officers certify they have completed the training"	"WQUES"
"Why am I missing some search filters "	"I do not know why you are missing some search filters"	"WQUES"
"Is there a cash point at the Zoo "	"I do not know if there is a cash point at the Zoo"	"BE_HAVE_MD_QUESTION"
"Do I have to give an employee a hearing before I dismiss an employee on performance or misconduct grounds"	"I do not know if you have to give an employee a hearing before you dismiss an employee on performance or misconduct grounds"	"DO_QUESTION"
"I ca n't get the cord out of the back of the toaster , is this supposed to be this short "	"I do not know if this is supposed to be this short"	"BE_HAVE_MD_QUESTION"
"What about a version of that but with a lot more inside jokes and less helpfulness "	"I do not know what about a version of that but with a lot more inside jokes and less helpfulness"	"WQUES_SIMPLE"
"How much are tuition fees at French universities "	"I do not know how much tuition fees are at French universities"	"WQUES"
"Who do I contact if I need help "	"I do not know who you contact if you need help"	"WQUES"
"Can I bring my pet "	"I do not know if you can bring your pet"	"BE_HAVE_MD_QUESTION"
"Is the salary level threshold for determining exempt status under the Fair Labor Standards Act based on salary and the cost of benefits "	"I do not know if the salary level threshold is for determining exempt status under the Fair Labor Standards Act based on salary and the cost of benefits"	"BE_HAVE_MD_QUESTION"
"How and when is my vacation accrual calculated "	"I do not know how and when your vacation accrual is calculated"	"WQUES"
"What other similar products do you offer "	"I do not know what other similar products I offer"	"WQUES"
"Why your forms are so long "	"I do not know why my forms are so long"	"WQUES_SIMPLE"
"Is SMoCA open on holidays "	"I do not know if smoca is open on holidays"	"BE_HAVE_MD_QUESTION"
"This plane ticket is way too expensive for me , can I exchange it for something else more affordable "	"I do not know if you can exchange it for something else more affordable"	"BE_HAVE_MD_QUESTION"
"How do I exchange an order I purchased online "	"I do not know how you exchange an order you purchased online"	"WQUES"
"How long until my tracking number is activated to be viewed "	"I do not know how long your tracking number until is activated to be viewed"	"WQUES"
"What if I have a problem with my spot or positioning "	"I do not know what you if have a problem with your spot or positioning"	"WQUES"
"I got home from your store and realized that my wallet was missing , is it there "	"I do not know if it is there"	"BE_HAVE_MD_QUESTION"
"How much to upgrade my services "	"I do not know how much to upgrade your services"	"WQUES_SIMPLE"
"Why am I being prompted to change or verify the name that appears on my MileagePlus account "	"I do not know why you are being prompted to change or verify the name that appears on your MileagePlus account"	"WQUES"
"If it is wet , is there anywhere to eat our packed lunches "	"I do not know if there is anywhere to eat your packed lunches"	"BE_HAVE_MD_QUESTION"
"Do you offer digital gift cards that I can email to someone "	"I do not know if I offer digital gift cards that you can email to someone"	"DO_QUESTION"
"Do I need a visa to study in France "	"I do not know if you need a visa to study in France"	"DO_QUESTION"
"What is the Railway Labor Act -LRB- RLA -RRB- "	"I do not know what the Railway Labor Act -LRB- RLA -RRB- is"	"WQUES"
"Can my child makeup a missed class "	"I do not know if your child can makeup a missed class"	"BE_HAVE_MD_QUESTION"
"When does my membership begin "	"I do not know when your membership begins"	"WQUES"
"Did my purchase go through"	"I do not know if your purchase went through"	"DO_QUESTION"
"Do your vehicles carry a Factory Warranty "	"I do not know if my vehicles carry a Factory Warranty"	"DO_QUESTION"
"Can I bring food & drinks to SMoCA "	"I do not know if you can bring food & drinks to SMoCA"	"BE_HAVE_MD_QUESTION"
"Can you help me get this product faster "	"I do not know if I can help you get this product faster"	"BE_HAVE_MD_QUESTION"
"What is the cheapest cruise package to Alaska "	"I do not know what the cheapest cruise package to Alaska is"	"WQUES"
"What services do you provide for home health "	"I do not know what services I provide for home health"	"WQUES"
"How many frequent flyer points do I need to cash in for a flight from Dallas to Detroit on the 18th "	"I do not know how many frequent flyer points you need to cash in for a flight from Dallas to Detroit on the 18th"	"WQUES"
"Can I delay the shipment so it arrives closer to Christmas "	"I do not know if you can delay the shipment so it arrives closer to Christmas"	"BE_HAVE_MD_QUESTION"
"What programs are offered online "	"I do not know what programs are offered online"	"WQUES_SIMPLE"
"Will your stores honor any competitor coupons "	"I do not know if my stores will honor any competitor coupons"	"BE_HAVE_MD_QUESTION"
"Can you please help me reverse some of these over drafts charges "	"I do not know if I can help you reverse some of these over drafts charges"	"BE_HAVE_MD_QUESTION"
"How long do I have to return an item "	"I do not know how long you have to return an item"	"WQUES"
"Can I try this out before I buy it "	"I do not know if you can try this out before you buy it"	"BE_HAVE_MD_QUESTION"
"Do you have online services "	"I do not know if I have online services"	"DO_QUESTION"
"Are mobile devices permitted in the galleries "	"I do not know if mobile are devices permitted in the galleries"	"BE_HAVE_MD_QUESTION"
"Do I need to come to the Zoo to become a member "	"I do not know if you need to come to the Zoo to become a member"	"DO_QUESTION"
"What if I need to cancel my party "	"I do not know what you if need to cancel your party"	"WQUES"
"Where is Georgia Aquarium "	"I do not know where Georgia Aquarium is"	"WQUES"
"How long will my item be on backorder "	"I do not know how long will your item be on backorder"	"WQUES_SIMPLE"
"Are there any Yellowstone regulations I need to know about "	"I do not know if there are any Yellowstone regulations you need to know about"	"BE_HAVE_MD_QUESTION"
"I 'm trying to figure out when my order will be shipped "	"I do not know when your order will be shipped"	"WQUES"
"What is Latin dancing "	"I do not know what Latin dancing is"	"WQUES"
"What are the phone hours "	"I do not know what the phone hours are"	"WQUES"
"How do I set usage alerts for minutes , messaging or data on my device "	"I do not know how you set usage alerts for minutes , messaging or data on your device"	"WQUES"
"I was interested in investing in your business but do n't know who to talk to . Can you connect me with the proper agent "	"I do not know you were interested in investing in my business but n't know who to talk to ."	"WSUBJ"
"Is internet access available for visitors in the Museum "	"I do not know if internet access is available for visitors in the Museum"	"BE_HAVE_MD_QUESTION"
"Could you check if your company provide discount for large quantity purchase on a whole scale level"	"I do not know if I could check if my company provide discount for large quantity purchase on a whole scale level"	"BE_HAVE_MD_QUESTION"
"How do I check out "	"I do not know how you check out"	"WQUES"
"How long do I have to wait for a delivery "	"I do not know how long you have to wait for a delivery"	"WQUES"
"Northwestern accepts both the Coalition and Common Applications -- is there a preference "	"I do not know if there is a preference"	"BE_HAVE_MD_QUESTION"
"Why is it necessary in Workday for a full-time employee to enter their time worked in a day in separate blocks "	"I do not know why is it necessary in Workday for a full-time employee to enter their time worked in a day in separate blocks"	"WQUES_SIMPLE"
"My account is locked , how do I get back in "	"I do not know how you get back in"	"WQUES"
"Are there any special exhibits "	"I do not know if there are any special exhibits"	"BE_HAVE_MD_QUESTION"
"May I book a private event at the museum "	"I do not know if you may book a private event at the museum"	"BE_HAVE_MD_QUESTION"
"I just placed my order . Can I add another item to it"	"I do not know if you can add another item to it"	"BE_HAVE_MD_QUESTION"
"Do you offer supplemental insurance "	"I do not know if I offer supplemental insurance"	"DO_QUESTION"
"Why does the train go backward and forward "	"I do not know why the train goes backward and forward"	"WQUES"
"I was just accepted as a new hire at a company and need to register . Can you guide me through the process "	"I do not know if I can guide you through the process"	"BE_HAVE_MD_QUESTION"
"I am very upset with the service I received , what can you do about it "	"I do not know what I can do about it"	"WQUES"
"Can I transfer my assets to avoid the Estate Recovery Program "	"I do not know if you can transfer your assets to avoid the Estate Recovery Program"	"BE_HAVE_MD_QUESTION"
"Is it possible to reenter the museums "	"I do not know if it is possible to reenter the museums"	"BE_HAVE_MD_QUESTION"
"What is this "	"I do not know what this is"	"WQUES"
"I need to file a claim "	"I do not know how to file a claim"	"IMPERATIVE"
"May I have permission to link to your websites "	"I do not know if you may have permission to link to my websites"	"BE_HAVE_MD_QUESTION"
"Can you tell me the next time you 'll be receiving this item "	"I do not know if I can tell you the next time I 'll be receiving this item"	"BE_HAVE_MD_QUESTION"
"How can I provide feedback on my experience at MPSH "	"I do not know how you can provide feedback on your experience at MPSH"	"WQUES"
"Are the animals at your aquarium humanely treated "	"I do not know if the are animals at my aquarium humanely treated"	"BE_HAVE_MD_QUESTION"
"I submitted a request for the deletion of my domain , and the page is still visible , why "	"I do not know the page is still visible , why you submitted a request for the deletion of your domain , and"	"WQUES"
"Can a purchase a monthly pass for the train "	"I do not know if a can purchase a monthly pass for the train"	"BE_HAVE_MD_QUESTION"
"Is there an extra fee to use my card outside the country "	"I do not know if there is an extra fee to use your card outside the country"	"BE_HAVE_MD_QUESTION"
"May overtime be averaged out over two or more weeks "	"I do not know how to May overtime be averaged out over two or more weeks"	"IMPERATIVE"
"My bank account has been charged twice for my monthly subscription , can you help me resolve this "	"I do not know how to your bank account has been charged twice for your monthly"	"IMPERATIVE"
"How can I make a gift to Harvard University "	"I do not know how you can make a gift to Harvard University"	"WQUES"
"Please remove all of my billing information from my account "	"I do not know how to remove all of your billing information from your account"	"IMPERATIVE"
"Hi , i need help accessing my online account with you , can you help me "	"I do not know if I can help you"	"BE_HAVE_MD_QUESTION"
"How often are the machines disinfected at your gym ? I do not want to get sick going to gym "	"I do not know how often the machines disinfected at my gym are"	"WQUES"
"Is an employer required to file Section 6055 or Section 6056 information returns electronically "	"I do not know if an employer is required to file Section 6055 or Section 6056 information returns electronically"	"BE_HAVE_MD_QUESTION"
"I have a busy schedule , do I have to register for classes "	"I do not know if you have to register for classes"	"DO_QUESTION"
"I am a beginner , will I still be able to perform at shows "	"I do not know if you will still be able to perform at shows"	"BE_HAVE_MD_QUESTION"
"My item is broken , is it covered under warantee "	"I do not know how to your item is broken , is it covered under warantee"	"IMPERATIVE"
"Are there any tickets still available for the concert "	"I do not know if there are any tickets still available for the concert"	"BE_HAVE_MD_QUESTION"
"With Roma Pass 72 Hours do the free entries necessarily have to be the first two admissions at museums and/or sites "	"I do not know how to handle 'With Roma Pass 72 Hours do the free entries necessarily have to be the first two admissions at museums and/or sites '"	"CANONICAL_IDK"
"Are all employees entitled to earn leave "	"I do not know if all employees are entitled to earn leave"	"BE_HAVE_MD_QUESTION"
"How can I get to the Museum on public transportation "	"I do not know how you can get to the Museum on public transportation"	"WQUES"
"My package was supposed to arrive yesterday . It has n't . Can you please check on it "	"I do not know how to your package was supposed to arrive yesterday ."	"IMPERATIVE"
"My university required each incoming freshman to come to school with their own computer . Is there any way to deduct the cost of the computer from my tax liability "	"I do not know if there is any way to deduct the cost of the computer from your tax liability"	"BE_HAVE_MD_QUESTION"
"Can you tell my why my shipment was delayed "	"I do not know if I can tell your why your shipment was delayed"	"BE_HAVE_MD_QUESTION"
"How much does it cost to perform at ZOO Venues "	"I do not know how much it costs to perform at ZOO Venues"	"WQUES"
"Is there a suggested route for visitors "	"I do not know if there is a suggested route for visitors"	"BE_HAVE_MD_QUESTION"
"Can I use my membership at other zoos and AQUARIUMS"	"I do not know if you can use your membership at other zoos and AQUARIUMS"	"BE_HAVE_MD_QUESTION"
"Where can I find height requirements and restrictions for your rides and attractions "	"I do not know where you can find height requirements and restrictions for my rides and attractions"	"WQUES"
"I think my card has been stolen ; can you tell me what to do to protect against identity theft "	"I do not know you think your card has been stolen ; can I tell you what to do to protect against identity theft"	"WSUBJ"
"Is Chevrolet currently offering any incentives or Special Offers "	"I do not know if Chevrolet is currently offering any incentives or Special Offers"	"BE_HAVE_MD_QUESTION"
"How long does an interview take "	"I do not know how long an interview takes"	"WQUES"
"I recently changed my package for my phone , internet , and cable and was told that the price drop would show on my next bill . I just received my most recent bill and am not showing any decrease in price for bundling these services . Can you find out why the price change was not reflected on this months bill "	"I do not know if I can find out why the price change was not reflected on this months bill"	"BE_HAVE_MD_QUESTION"
"What equipment is needed to collect fossils "	"I do not know what equipment to collect fossils What equipment is needed"	"WQUES"
"How long can I stay out in the backcountry "	"I do not know how long you can stay out in the backcountry"	"WQUES"
"What are the dining options at The Field Museum "	"I do not know what the dining options at The Field Museum are"	"WQUES"
"Do any of these clothing items come in contact with peanut products "	"I do not know if any of these clothing items come in contact with peanut products"	"DO_QUESTION"
"Since I ordered more then one good will it all be in one package or will they be separated "	"I do not know how to handle 'Since I ordered more then one good will it all be in one package or will they be separated '"	"CANONICAL_IDK"
"Is there an extra fee to withdraw cash with my credit card "	"I do not know if there is an extra fee to withdraw cash with your credit card"	"BE_HAVE_MD_QUESTION"
"Should I make a reservation for a tour"	"I do not know if you should make a reservation for a tour"	"BE_HAVE_MD_QUESTION"
"What if I also have a child at Camp Joey "	"I do not know what you if also have a child at Camp Joey"	"WQUES"
"If I Have Previously Completed An Application , Will I Automatically Be Considered For Other Positions "	"I do not know if you will Automatically Be Considered For Other Positions"	"BE_HAVE_MD_QUESTION"
"If I were to upgrade my line , how much extra per month would it be "	"I do not know how much extra per month it would be"	"WQUES"
"If I 'm coming with a group , do I need to make a reservation "	"I do not know if you need to make a reservation"	"DO_QUESTION"
"I have received an error message stating my entry contained invalid characters . Which characters are valid "	"I do not know which characters are valid"	"WQUES_SIMPLE"
"What happened to the money "	"I do not know what happened to the money"	"WSUBJ"
"How much does the Artmobile cost "	"I do not know how much does the Artmobile cost"	"WQUES_SIMPLE"
"What is replacement planning "	"I do not know what replacement planning is"	"WQUES"
"Is the current sale on your website 24 or 48 hours "	"I do not know if the is current sale on my website 24 or 48 hours"	"BE_HAVE_MD_QUESTION"
"How can I find out about discounts "	"I do not know how you can find out about discounts"	"WQUES"
"Do you offer any sort of discounts for customers on their birthday "	"I do not know if I offer any sort of discounts for customers on their birthday"	"DO_QUESTION"
"Can I add my company logo and customize Kin "	"I do not know if you can add your company logo and customize Kin"	"BE_HAVE_MD_QUESTION"
"Can I return something that was broken "	"I do not know if you can return something that was broken"	"BE_HAVE_MD_QUESTION"
"How much recovery time is needed after the lasik eye surgery "	"I do not know how much recovery time is needed after the lasik eye surgery"	"WQUES_SIMPLE"
"What type of individual is the program seeking to find "	"I do not know what type of individual the program seeking to find is"	"WQUES"
"Can I rent a wheelchair or STROLLER"	"I do not know if you can rent a wheelchair or STROLLER"	"BE_HAVE_MD_QUESTION"
"Can I speak to a district manager "	"I do not know if you can speak to a district manager"	"BE_HAVE_MD_QUESTION"
"What do we offer for infants and Toddlers"	"I do not know what you offer for infants and Toddlers"	"WQUES"
"May I wear Heelys or in-line skates , or bring a skate board or bicycle on-site "	"I do not know if you may wear Heelys or in-line skates , or bring a skate board or bicycle on-site"	"BE_HAVE_MD_QUESTION"
"Can I apply the in store promotion online "	"I do not know if you can apply the in store promotion online"	"BE_HAVE_MD_QUESTION"
"Is it free to visit the 9/11 Memorial "	"I do not know if it is free to visit the 9/11 Memorial"	"BE_HAVE_MD_QUESTION"
"Can I split my order over two cards "	"I do not know if you can split your order over two cards"	"BE_HAVE_MD_QUESTION"
"How much soy does your meat contain "	"I do not know how much soy my meat contains"	"WQUES_SIMPLE"
"How can I find an enrollment center "	"I do not know how you can find an enrollment center"	"WQUES"
"I accidentally placed an order before getting all the items I wanted shipped in there , can I still add those to combine shipping "	"I do not know if you can still add those to combine shipping"	"BE_HAVE_MD_QUESTION"
"Who owns the Museum"	"I do not know who owns the Museum"	"WSUBJ"
"What fees may apply to the HIPAA Electronic Funds Transfer -LRB- EFT -RRB- transaction "	"I do not know what fees may apply to the HIPAA Electronic Funds Transfer -LRB- EFT -RRB- transaction"	"WQUES_SIMPLE"
"How often will the opportunity be provided to convert / open election periods "	"I do not know how often the opportunity will be provided to convert / open election periods"	"WQUES"
"Is Discover accepted "	"I do not know if Discover is accepted"	"BE_HAVE_MD_QUESTION"
"Is it possible to leave the Museum and return that day "	"I do not know if it is possible to leave the Museum and return that day"	"BE_HAVE_MD_QUESTION"
"Up to what age do children stay free of charge "	"I do not know what age children to stay free of charge"	"WQUES"
"Do I get a discount for visiting as a group "	"I do not know if you get a discount for visiting as a group"	"DO_QUESTION"
"I 'm looking for a book of poetry . Can you help me "	"I do not know if I can help you"	"BE_HAVE_MD_QUESTION"
"Do I have to offer the same benefits to all employees "	"I do not know if you have to offer the same benefits to all employees"	"DO_QUESTION"
"Do you hold any rooms back for telephone bookings "	"I do not know if I hold any rooms back for telephone bookings"	"DO_QUESTION"
"Where can I go to see a physical therapist that my insurance provider will cover with my policy "	"I do not know where you can go to see a physical therapist that your insurance provider will cover with your policy"	"WQUES"
"Should I take my routine medications before surgery "	"I do not know if you should take your routine medications before surgery"	"BE_HAVE_MD_QUESTION"
"How can I change the credit card that 's being used on my account "	"I do not know how you can change the credit card that 's being used on your account"	"WQUES"
"My creditcard is not accepted , what can I do "	"I do not know what you can do"	"WQUES"
"Is there special knowledge required to use HeavenHR "	"I do not know if there special knowledge is required to use HeavenHR"	"BE_HAVE_MD_QUESTION"
"How can I request a ticket donation from the Museum for our fundraiser "	"I do not know how you can request a ticket donation from the Museum for your fundraiser"	"WQUES"
"Is it necessary for my child to dance over their summer vacation in order to advance at a typical pace "	"I do not know if it is necessary for your child to dance over their summer vacation in order to advance at a typical pace"	"BE_HAVE_MD_QUESTION"
"I hold a French residence permit -LRB- carte de séjour -RRB- but have lost it . Do I need a visa "	"I do not know if you need a visa"	"DO_QUESTION"
"I am going to Phoenix on December 20th and would like to know the cheapest rates available "	"I do not know how to handle 'I am going to Phoenix on December 20th and would like to know the cheapest rates available '"	"CANONICAL_IDK"
"I 'm not sure why this is happening , but I ca n't order from your site as the checkout process does n't work"	"I do not know why this is happening"	"WQUES"
"Can I use united.com Club deposits to pay for my taxes and fees for an award ticket -LRB- mileage redemption -RRB- "	"I do not know if you can use united.com Club deposits to pay for your taxes and fees for an award ticket -LRB- mileage redemption -RRB-"	"BE_HAVE_MD_QUESTION"
"Can i file a complaint thru you "	"I do not know if you can file a complaint thru me"	"BE_HAVE_MD_QUESTION"
"Do you have any specials if I place an order today "	"I do not know if I have any specials if you place an order today"	"DO_QUESTION"
"I bought a pair of jeans but they do n't fit quite right , can you alter them for me "	"I do not know if I can alter them for you"	"BE_HAVE_MD_QUESTION"
"Is there street parking "	"I do not know if there is street parking"	"BE_HAVE_MD_QUESTION"
"In the case of a model that supports different languages , how do I change the ClassWiz language setting "	"I do not know how you change the ClassWiz language setting"	"WQUES"
"Where can I purchase this specific product besides online "	"I do not know where you can purchase this specific product besides online"	"WQUES"
"How long does the permitting process take "	"I do not know how long the permitting process takes"	"WQUES"
"Can I donate my pet to the Zoo "	"I do not know if you can donate your pet to the Zoo"	"BE_HAVE_MD_QUESTION"
"What if I want to visit another zoo and I do not have my membership card"	"I do not know what you if want to visit another zoo and you not have your membership card"	"WQUES"
"May I leave and come back in "	"I do not know if you may leave and come back in"	"BE_HAVE_MD_QUESTION"
"Can you tell me what the new features of your new phone model are"	"I do not know if I can tell you what the new features of my new phone model are"	"BE_HAVE_MD_QUESTION"
"When does the free trial end "	"I do not know when does the free trial end"	"WQUES_SIMPLE"
"When do I need to submit my claim form "	"I do not know when you need to submit your claim form"	"WQUES"
"What is the average shipping time for an order like mine "	"I do not know what the average shipping time for an order like yours is"	"WQUES"
"What is the difference between all-wheel drive and four-wheel drive "	"I do not know what the difference between all-wheel drive and four-wheel drive is"	"WQUES"
"Is it true that I can get all the vitamins/minerals I need from the food that I eat "	"I do not know if it is true that you can get all the vitamins/minerals you need from the food that you eat"	"BE_HAVE_MD_QUESTION"
"Where should we keep employee records "	"I do not know where you should keep employee records"	"WQUES"
"Will I be able to receive calls and text messages while browsing the Web with att.net "	"I do not know if you will be able to receive calls and text messages while browsing the Web with att.net"	"BE_HAVE_MD_QUESTION"
"Can I watch a game that I 'm not playing in "	"I do not know if you can watch a game that you are not playing in"	"BE_HAVE_MD_QUESTION"
"How do I put a rush on my claim "	"I do not know how you put a rush on your claim"	"WQUES"
"Can you tell me how much credit I have available "	"I do not know if I can tell you how much credit you have available"	"BE_HAVE_MD_QUESTION"
"Can I get a star named after me and claim copyright to it "	"I do not know if you can get a star named after you and claim copyright to it"	"BE_HAVE_MD_QUESTION"
"Could you help me find a prom dress for my daughter "	"I do not know if I could help you find a prom dress for your daughter"	"BE_HAVE_MD_QUESTION"
"I recently ate at your establishment . I ordered the lobster and it made me very sick . Can you connect me with the correct person to address this "	"I do not know if I can connect you with the correct person to address this"	"BE_HAVE_MD_QUESTION"
"What 's my order number"	"I do not know what your order number 's"	"WQUES"
"Do you have a showroom "	"I do not know if I have a showroom"	"DO_QUESTION"
"Is it possible for me to collect a package at an earlier time instead of waiting for it to be delivered to me "	"I do not know if it is possible for you to collect a package at an earlier time instead of waiting for it to be delivered to you"	"BE_HAVE_MD_QUESTION"
"What is the most prominent religion of Mexicans "	"I do not know what the prominent religion of Mexicans is most"	"WQUES"
"When can I upgrade a device "	"I do not know when you can upgrade a device"	"WQUES"
"Do you have a list of the aircraft on display in the museum "	"I do not know if I have a list of the aircraft on display in the museum"	"DO_QUESTION"
"Where is the closest location of an onsite store "	"I do not know where the closest location of an onsite store is"	"WQUES"
"What is the rating scale used at DePaul "	"I do not know what the rating scale used at DePaul is"	"WQUES"
"What are the best times to avoid crowds "	"I do not know what the best times to avoid crowds are"	"WQUES"
"Does the Museum have a parking lot "	"I do not know if the Museum has a parking lot"	"DO_QUESTION"
"What is the dress code "	"I do not know what the dress code is"	"WQUES"
"Can I bring my car club "	"I do not know if you can bring your car club"	"BE_HAVE_MD_QUESTION"
"Can I request a summary of my purchases "	"I do not know if you can request a summary of your purchases"	"BE_HAVE_MD_QUESTION"
"Can I personally deliver the donation to the museum "	"I do not know if you can personally deliver the donation to the museum"	"BE_HAVE_MD_QUESTION"
"How do I open an account "	"I do not know how you open an account"	"WQUES"
"I am receiving error messages trying to complete the order . What should I do "	"I do not know what you should do"	"WQUES"
"What sorts of products should I use for cooking "	"I do not know what sorts of products you should use for cooking"	"WQUES"
"Why would you put egg shell in coffee "	"I do not know why I would put egg shell in coffee"	"WQUES"
"I need to send in some information but it 's not going through on the site . What do I do "	"I do not know what you do"	"WQUES"
"Do I need to give a privacy notice to everyone who walks into my showroom "	"I do not know if you need to give a privacy notice to everyone who walks into your showroom"	"DO_QUESTION"
"What types of training are available for my company "	"I do not know what types of training are available for your company"	"WQUES_SIMPLE"
"I did not get an email saying that I am potentially eligible and as a result , I can not access the continuing appointments menus in inspira to conduct the review . However I meet the requirements to be considered . How can I request access "	"I do not know how you can request access"	"WQUES"
"How much do you charge for newspaper delivery "	"I do not know how much I charge for newspaper delivery"	"WQUES"
"Is our Vision Care covered on the Extended Health Claim Form "	"I do not know if your Vision Care is covered on the Extended Health Claim Form"	"BE_HAVE_MD_QUESTION"
"What if I want to make changes to the E-TRAC that I 've already submitted "	"I do not know what you if want to make changes to the E-TRAC that you 've already submitted"	"WQUES"
"Where can I have a work of art cleaned or conserved "	"I do not know where you can have a work of art cleaned or conserved"	"WQUES"
"My son almost blew his hands off when your toy he was playing with suddenly exploded . I need you to give me all pertinent corporate information . I am going to sue "	"I do not know when my toy he was playing with suddenly exploded your son almost blew his hands off ."	"WQUES"
"Why outsource human resources duties to a PEO "	"I do not know why outsource human resources duties to a PEO"	"WQUES_SIMPLE"
"I 'd like to own a See 's franchise . How do I get started "	"I do not know how to own a See 's franchise ."	"IMPERATIVE"
"May an employer terminate a pension plan "	"I do not know if an employer may terminate a pension plan"	"BE_HAVE_MD_QUESTION"
"How does it relieve me from too much workload "	"I do not know how it relieves you from too much workload"	"WQUES"
"Are your orders shipped via FedEx "	"I do not know if my orders are shipped via FedEx"	"BE_HAVE_MD_QUESTION"
"What is the proximity of the HRR to Hueco Tanks State Park "	"I do not know what the proximity of the HRR to Hueco Tanks State Park is"	"WQUES"
"I have previously worked for the Federal government , am I eligible to apply "	"I do not know how to handle 'I have previously worked for the Federal government , am I eligible to apply '"	"CANONICAL_IDK"
"My television service is out . Is this the correct number to call to find out if there is a service outage "	"I do not know if this is the correct number to call to find out if there is a service outage"	"BE_HAVE_MD_QUESTION"
"What happens if I lose something in the Zoo "	"I do not know what happens if you lose something in the Zoo"	"WSUBJ"
"Can I reserve a place for a tour or encounter without payment"	"I do not know if you can reserve a place for a tour or encounter without payment"	"BE_HAVE_MD_QUESTION"
"Help ! I have an unusual application and I do n't know what slide product to use"	"I do not know how to help !"	"IMPERATIVE"
"How can I Increase the number of Amazon S3 buckets that I can provision "	"I do not know how you can Increase the number of Amazon S3 buckets that you can provision"	"WQUES"
"Are foreign documents need to be endorsed by a diplomatic or consular mission , and are they need to be translated "	"I do not know if foreign documents are need to be endorsed by a diplomatic or consular mission , and are they need to be translated"	"BE_HAVE_MD_QUESTION"
"How do I apply for a job with the National Park Service "	"I do not know how you apply for a job with the National Park Service"	"WQUES"
"I received my iWatch order today . Can you help me configure the network settings on my iWatch "	"I do not know if I can help you configure the network settings on your iWatch"	"BE_HAVE_MD_QUESTION"
"Do I only pay the registration fee once "	"I do not know if you only pay the registration fee once"	"DO_QUESTION"
"I need to rent a car to drive to Denver . What type of pricing do you have for an economy model one way "	"I do not know how to rent a car to drive to Denver ."	"IMPERATIVE"
"How can I apply to Vanderbilt "	"I do not know how you can apply to Vanderbilt"	"WQUES"
"How can an employer prevent the nonrepayment of overpaid wages that may result if a new employee quits shortly after receiving a signing bonus and other benefits "	"I do not know how an employer can prevent the nonrepayment of overpaid wages that may result if a new employee quits shortly after receiving a signing bonus and other benefits"	"WQUES"
"I forgot to use the coupon code . Is there any way you can refund me the difference or cancel my order so I can reorder with the coupon "	"I do not know if there is any way I can refund you the difference or cancel your order so you can reorder with the coupon"	"BE_HAVE_MD_QUESTION"
"I am due to retire on or after 1 January 2018 at age 60 or 62 . Under the ICSC compensation package , the mandatory age of retirement for all staff members on board as of 1 January 2018 will be 65 . Will I be eligible for the continuing appointment now that I will have 7 years remaining from the eligibility date until I turn 65 "	"I do not know how to under the ICSC compensation"	"IMPERATIVE"
"Where do I go for my inspection "	"I do not know where you go for your inspection"	"WQUES"
"Can you please tell me how to return my package "	"I do not know if I can tell you how to return your package"	"BE_HAVE_MD_QUESTION"
"I ca n't find the extension of the person I am trying to reach . Can you help me navigate your directory "	"I do not know if I can help you navigate my directory"	"BE_HAVE_MD_QUESTION"
"I 'm wondering if I 'm able to bundle Earthquake insurance since I currently receive life , car and home insurance with your company "	"I do not know how to car and home insurance with my company"	"IMPERATIVE"
"I received a refund in a wallet and how do I transfer to the original form of payment which was my credit card"	"I do not know how you transfer to the original form of payment which was your credit card"	"WQUES"
"Is your milk made with hormones "	"I do not know if my milk is made with hormones"	"BE_HAVE_MD_QUESTION"
"What options are available "	"I do not know what options are available"	"WQUES_SIMPLE"
"How much alcohol can each adult bring onboard "	"I do not know how much alcohol each adult can bring onboard"	"WQUES"
"Is there a giant panda at Zoo Berlin "	"I do not know if there is a giant panda at Zoo Berlin"	"BE_HAVE_MD_QUESTION"
"May I transfer my membership to someone else "	"I do not know if you may transfer your membership to someone else"	"BE_HAVE_MD_QUESTION"
"Am I qualified for a loan of my credit is average or I need to have someone to co-sign "	"I do not know if you are qualified for a loan of your credit is average or you need to have someone to co-sign"	"BE_HAVE_MD_QUESTION"
"Can you connect me to someone in billing "	"I do not know if I can connect you to someone in billing"	"BE_HAVE_MD_QUESTION"
"Are authority records available as linked data "	"I do not know if authority are records available as linked data"	"BE_HAVE_MD_QUESTION"
"Can I arrange to have materials waiting for me when I get there "	"I do not know if you can arrange to have materials waiting for you when you get there"	"BE_HAVE_MD_QUESTION"
"How do I apply for a job at Mandalay Bay "	"I do not know how you apply for a job at Mandalay Bay"	"WQUES"
"What can I do if I receive my packsage and it is damaged "	"I do not know what you can do if you receive your packsage and it is damaged"	"WQUES"
"Can you check in your records and find my purchase history "	"I do not know if I can check in my records and find your purchase history"	"BE_HAVE_MD_QUESTION"
"I found a beautiful shirt but I was wondering if I could put in a request for a bigger size and different color "	"I do not know how to handle 'I found a beautiful shirt but I was wondering if I could put in a request for a bigger size and different color '"	"CANONICAL_IDK"
"What are the office hours of operation "	"I do not know what the office hours of operation are"	"WQUES"
"Is free return shipping offered "	"I do not know if free return shipping is offered"	"BE_HAVE_MD_QUESTION"
"How long will it take for me to move from Level 1 to the next level"	"I do not know how long it will take for you to move from Level 1 to the next level"	"WQUES"
"Could you indicate the status of my shipping order "	"I do not know if I could indicate the status of your shipping order"	"BE_HAVE_MD_QUESTION"
"As the owner of a business , am I required to complete Form I-9 , Employment Eligibility Verification "	"I do not know how to as the owner of a business , am you required to complete Form I-9 , Employment Eligibility Verification"	"IMPERATIVE"
"When can I arrive "	"I do not know when you can arrive"	"WQUES"
"Is there a page on your website where I can see the new merchandise "	"I do not know if there is a page on my website where you can see the new merchandise"	"BE_HAVE_MD_QUESTION"
"Is there a basic phone option on The Verizon Plan "	"I do not know if there is a basic phone option on The Verizon Plan"	"BE_HAVE_MD_QUESTION"
"How do I join or renew my membership "	"I do not know how you join or renew your membership"	"WQUES"
"Do you guys offer repair services for items "	"I do not know if I guys offer repair services for items"	"DO_QUESTION"
"How long does it take for a backordered item to ship "	"I do not know how long it takes for a backordered item to ship"	"WQUES"
"Are there any obligations from the organization "	"I do not know if there are any obligations from the organization"	"BE_HAVE_MD_QUESTION"
"I want to place an order and the website is down . Can you put the order in for me or do I have to wait for the website "	"I do not know if I can put the order in for you or you have to wait for the website"	"BE_HAVE_MD_QUESTION"
"I 'd like to pick up my package exactly a week from now , can we make this adjustment now if possible "	"I do not know how to pick up your package exactly a week from"	"IMPERATIVE"
"How do retailers handle sales of sets containing both exempt and taxable items "	"I do not know how retailers handle sales of sets containing both exempt and taxable items"	"WQUES_SIMPLE"
"If my child applies for one theme school -LRB- Zoo , Blandford , and Center for Economicology -RRB- and does n't like it , can they transfer to another theme school "	"I do not know how to and Center for Economicology -RRB- and n't likes"	"IMPERATIVE"
"Do you ship out orders the same day "	"I do not know if I ship out orders the same day"	"DO_QUESTION"
"I placed an order online and selected the wrong size shirt , can you change that for me "	"I do not know if I can change that for you"	"BE_HAVE_MD_QUESTION"
"There is a fraudulent charge on my bank statement . Can you please look into this "	"I do not know if I can look into this"	"BE_HAVE_MD_QUESTION"
"How many calories do I need to burn to lose a pound of weight "	"I do not know how many calories you need to burn to lose a pound of weight"	"WQUES"
"How to read my invitation "	"I do not know how to read your invitation"	"WQUES_SIMPLE"
"If I order a fruit basket , is it shipped chilled "	"I do not know if it is shipped chilled"	"BE_HAVE_MD_QUESTION"
"What do the abbreviations on my paycheck mean "	"I do not know what do the abbreviations on your paycheck mean"	"WQUES_SIMPLE"
"I want this parcel to be properly insured , but I 'm not sure how to go about it . Can you help me "	"I do not know how to this parcel to be properly"	"IMPERATIVE"
"Will you recruit or head hunt employees for us "	"I do not know if I will recruit or head hunt employees for you"	"BE_HAVE_MD_QUESTION"
"How can I verify the location of a package ? I ask because I still have not received my order"	"I do not know how you can verify the location of a package"	"WQUES"
"What is the difference between these products "	"I do not know what the difference between these products is"	"WQUES"
"Where can I leave a review for your product "	"I do not know where you can leave a review for my product"	"WQUES"
"What is the admission fee for Students"	"I do not know what the admission fee for Students is"	"WQUES"
"I want to upgrade my phone and I am not able to do it online at the moment , would you please help me"	"I do not know if I would help you"	"BE_HAVE_MD_QUESTION"
"Can I request a quote "	"I do not know if you can request a quote"	"BE_HAVE_MD_QUESTION"
"What will I be seeing at the Vatican "	"I do not know what you will be seeing at the Vatican"	"WQUES"
"Is the enamel surface scratch-resistant "	"I do not know if the enamel surface is scratch-resistant"	"BE_HAVE_MD_QUESTION"
"What kind of art do you have at the MCA "	"I do not know what kind of art I have at the MCA"	"WQUES"
"What else is there to do in Santa 's Town "	"I do not know what else is there to do in Santa 's Town"	"WQUES_SIMPLE"
"Where and how do I vote "	"I do not know where and how you vote"	"WQUES"
"Can I become an American Friend of the Prado Museum if I 'm not from the USA "	"I do not know if you can become an American Friend of the Prado Museum if you are not from the USA"	"BE_HAVE_MD_QUESTION"
"What are the office hours "	"I do not know what the office hours are"	"WQUES"
"How do I set up a candle fundraising campaign for my school "	"I do not know how you set up a candle fundraising campaign for your school"	"WQUES"
"Why have n't I received my tracking code for my package "	"I do not know why you have n't received your tracking code for your package"	"WQUES"
"Where do I call for information on health screenings "	"I do not know where you call for information on health screenings"	"WQUES"
"May I take photographs of the art "	"I do not know if you may take photographs of the art"	"BE_HAVE_MD_QUESTION"
"Are there any car parking charges "	"I do not know if there are any car parking charges"	"BE_HAVE_MD_QUESTION"
"How many beds does Children 's Hospital have "	"I do not know how many beds Children 's Hospital has"	"WQUES_SIMPLE"
"I would like to change my mobile phone plan . How much more a month will it be for an unlimited plan "	"I do not know how to change your mobile phone plan ."	"IMPERATIVE"
"What care services will be reflected on the new UVA Health System statement "	"I do not know what care services will be reflected on the new UVA Health System statement"	"WQUES_SIMPLE"
"Can pupils under 11 years old also follow an educational programme "	"I do not know if pupils can under 11 years old also follow an educational programme"	"BE_HAVE_MD_QUESTION"
"Who can I speak with about donating items or animals to the Museum "	"I do not know who you can speak with about donating items or animals to the Museum"	"WQUES"
"Where can I purchase genuine Kia parts and accessories "	"I do not know where you can purchase genuine Kia parts and accessories"	"WQUES"
"How can I view My CDW Advantage price while I shop "	"I do not know how you can view your CDW Advantage price while you shop"	"WQUES"
"What is dessert like in Guatemala"	"I do not know what dessert like in Guatemala is"	"WQUES"
"Is it true that tickets for The Polar Express ™ sell quickly "	"I do not know if it is true that tickets for The Polar Express ™ sell quickly"	"BE_HAVE_MD_QUESTION"
"Do you have Military discounts available "	"I do not know if I have Military discounts available"	"DO_QUESTION"
"How much will taxes cost on my order "	"I do not know how much taxes will cost on your order"	"WQUES"
"What payment structure did Oregon choose for eligible hospitals "	"I do not know what payment structure Oregon chose for eligible hospitals"	"WQUES_SIMPLE"
"Are there bike racks "	"I do not know if there are bike racks"	"BE_HAVE_MD_QUESTION"
"Can one Nut be used by another account after delete "	"I do not know if one Nut can be used by another account after delete"	"BE_HAVE_MD_QUESTION"
"Are your clothing items true to size "	"I do not know if my clothing items are true to size"	"BE_HAVE_MD_QUESTION"
"Do we need to track telecommuting requests or send copies of the agreements to Human Resources "	"I do not know if you need to track telecommuting requests or send copies of the agreements to Human Resources"	"DO_QUESTION"
"How many people does my membership admit per day "	"I do not know how many people your membership admits per day"	"WQUES"
"Can you help me change the pin code to my account so I can access it "	"I do not know if I can help you change the pin code to your account so you can access it"	"BE_HAVE_MD_QUESTION"
"What do I need to get started "	"I do not know what you need to get started"	"WQUES"
"Who can I talk to about a lost package "	"I do not know who you can talk to about a lost package"	"WQUES"
"What data speeds can I expect from my 4G LTE device while traveling outside the US "	"I do not know what data speeds you can expect from your 4G LTE device while traveling outside the you"	"WQUES"
"I am a graduate student receiving health insurance from the university but my address has changed and I can not change it through the insurance provider , can you help me make this change "	"I do not know if I can help you make this change"	"BE_HAVE_MD_QUESTION"
"Where can I get copies -LRB- reproductions -RRB- of the Charters of Freedom "	"I do not know where you can get copies -LRB- reproductions -RRB- of the Charters of Freedom"	"WQUES"
"Can I send my order to multiple recipients "	"I do not know if you can send your order to multiple recipients"	"BE_HAVE_MD_QUESTION"
"Can you help me set parental controls "	"I do not know if I can help you set parental controls"	"BE_HAVE_MD_QUESTION"
"What kind of the payment methods for domestic flight tickets can I use "	"I do not know what kind of the payment methods for domestic flight tickets you can use"	"WQUES"
"Are agents available after 5 pm "	"I do not know if agents are available after 5 pm"	"BE_HAVE_MD_QUESTION"
"Are your cosmetics tested on animals "	"I do not know if my cosmetics are tested on animals"	"BE_HAVE_MD_QUESTION"
"Can you gift wrap my item "	"I do not know if I can gift wrap your item"	"BE_HAVE_MD_QUESTION"
"What time does your customer service line close in the evening "	"I do not know what time does my customer service line close in the evening"	"WQUES_SIMPLE"
"How does an employer classify an employee who performs two or more distinct types of jobs "	"I do not know how an employer classifies an employee who performs two or more distinct types of jobs"	"WQUES"
"If service starts in the middle of a billing period is it pro rated "	"I do not know if it is pro rated"	"BE_HAVE_MD_QUESTION"
"Please tell me when my package is expected to arrive "	"I do not know when your package is expected to arrive"	"WQUES"
"I need to set up auto pay "	"I do not know how to set up auto pay"	"IMPERATIVE"
"Do you have locker rooms and showers "	"I do not know if I have locker rooms and showers"	"DO_QUESTION"
"Can I pay with a Visa card "	"I do not know if you can pay with a Visa card"	"BE_HAVE_MD_QUESTION"
"How strong is the scientific evidence that Earth is warming and that humans are the main cause "	"I do not know how strong the scientific evidence that Earth is warming and that humans are the main cause is"	"WQUES"
"Do all oceans have tsunamis "	"I do not know if all oceans have tsunamis"	"DO_QUESTION"
"What if I have a question "	"I do not know what you if have a question"	"WQUES"
"Does an employer have a right to search an employee 's locker or desk "	"I do not know if an employer has a right to search an employee 's locker or desk"	"DO_QUESTION"
"Can I change the cycle date on my account "	"I do not know if you can change the cycle date on your account"	"BE_HAVE_MD_QUESTION"
"Is training included "	"I do not know if training is included"	"BE_HAVE_MD_QUESTION"
"Ok , so how do I join "	"I do not know how Ok , so you join"	"WQUES"
"Can I make a payment "	"I do not know if you can make a payment"	"BE_HAVE_MD_QUESTION"
"I need to track my package"	"I do not know how to track your package"	"IMPERATIVE"
"Can I have a free upgrade "	"I do not know if you can have a free upgrade"	"BE_HAVE_MD_QUESTION"
"What if my tree does n't seem to be absorbing water in the stand "	"I do not know what your tree if n't seems to be absorbing water in the stand"	"WQUES"
"I found an injured baby bird or mammal ; what should I do "	"I do not know what you should do"	"WQUES"
"How do I choose a class that is right for me "	"I do not know how you choose a class that is right for you"	"WQUES"
"Where is an authorized service department for my new vehicle ? I need a tune up "	"I do not know where an authorized service department for your new vehicle is"	"WQUES"
"Can you please check on my order for me "	"I do not know if I can check on your order for you"	"BE_HAVE_MD_QUESTION"
"Do you accept credit cards "	"I do not know if I accept credit cards"	"DO_QUESTION"
"If I am a member , but am not able to visit Bishop Museum , can my children come without me "	"I do not know how to but am not able to visit Bishop"	"IMPERATIVE"
"How long are the group classes "	"I do not know how long the group classes are"	"WQUES"
"My card -LRB- s -RRB- was lost/damaged/stolen . How can I replace my card "	"I do not know how to your card -LRB- s -RRB- was lost/damaged/stolen ."	"IMPERATIVE"
"My toiled sometimes flush uncontrollably for like 10 minutes . Is there a DIY solution you can suggest "	"I do not know how to your toiled sometimes flush uncontrollably for like 10 minutes ."	"IMPERATIVE"
"What is the period of time within which the education award can be used "	"I do not know of time within which the education award can be used the education award can be used"	"WQUES"
"I did not turn in my paper Form I-94 when I left the United States , what should I do "	"I do not know when you left the United States"	"WQUES"
"Where can I go to sit in your chairs "	"I do not know where you can go to sit in my chairs"	"WQUES"
"Are we going to be touching live animals "	"I do not know if you are going to be touching live animals"	"BE_HAVE_MD_QUESTION"
"I need to order something for my company . Do you accept purchase orders and send invoices "	"I do not know how to order something for your company ."	"IMPERATIVE"
"Can I request a donation from Mandalay Bay "	"I do not know if you can request a donation from Mandalay Bay"	"BE_HAVE_MD_QUESTION"
"Why is my payment being declined"	"I do not know why your payment is being declined"	"WQUES"
"Can I see showtimes for different dates and locations "	"I do not know if you can see showtimes for different dates and locations"	"BE_HAVE_MD_QUESTION"
"Do I have to register with your office to be protected "	"I do not know if you have to register with my office to be protected"	"DO_QUESTION"
"May a union employee demand to have a union representative present during an investigative interview "	"I do not know if a may union employee demand to have a union representative present during an investigative interview"	"BE_HAVE_MD_QUESTION"
"Can the HUBZone office expedite my application "	"I do not know if the HUBZone office can expedite your application"	"BE_HAVE_MD_QUESTION"
"I 'm unable to attend the deep sea fishing tour on June 11th , can I reschedule for the 15th "	"I do not know if you can reschedule for the 15th"	"BE_HAVE_MD_QUESTION"
"How do I check the status of an order online "	"I do not know how you check the status of an order online"	"WQUES"
"My tooth pain just got much worse . Can we reschedule my dental appointment to as early as possible "	"I do not know if you can reschedule your dental appointment to as early as possible"	"BE_HAVE_MD_QUESTION"
"Why do you have a dress code "	"I do not know why I have a dress code"	"WQUES"
"Is it too late to add 2 to my quanitity of goods being shipped "	"I do not know if it is too late to add 2 to your quanitity of goods being shipped"	"BE_HAVE_MD_QUESTION"
"My question is n't answered here . Who can I contact "	"I do not know how to your question is n't answered here ."	"IMPERATIVE"
"Which international channels are available with this satellite service "	"I do not know which international channels are available with this satellite service"	"WQUES_SIMPLE"
"What happens if I move and/or my address changed "	"I do not know what happens if you move and/or your address changed"	"WSUBJ"
"Is photography permitted in the Museum "	"I do not know if photography is permitted in the Museum"	"BE_HAVE_MD_QUESTION"
"Are there audio guides inside the museum "	"I do not know if there audio guides are inside the museum"	"BE_HAVE_MD_QUESTION"
"How does the reciprocal program work "	"I do not know how does the reciprocal program work"	"WQUES_SIMPLE"
"Are the porterhouses fresh"	"I do not know if the porterhouses are fresh"	"BE_HAVE_MD_QUESTION"
"I want to know when I can expect my insurance to go into effect "	"I do not know when you can expect your insurance to go into effect"	"WQUES"
"Will you bill my credit card automatically to renew or should I call "	"I do not know if I will bill your credit card automatically to renew or should you call"	"BE_HAVE_MD_QUESTION"
"Will I receive a tracking number for my order "	"I do not know if you will receive a tracking number for your order"	"BE_HAVE_MD_QUESTION"
"Do you offer payment plans for re-activation "	"I do not know if I offer payment plans for re-activation"	"DO_QUESTION"
"I am the PD/PI on an NIH grant , but I am not the responsible party for the clinical trial that the grant supports . If the trial is not in compliance with FDAAA or in adherence with the NIH Policy on the Dissemination of NIH-Funded Clinical Trial Information , may I register or submit results of the trial in ClinicalTrials.gov "	"I do not know if you may register or submit results of the trial in ClinicalTrials.gov"	"BE_HAVE_MD_QUESTION"
"Can I land my plane at the Museum"	"I do not know if you can land your plane at the Museum"	"BE_HAVE_MD_QUESTION"
"I ca n't understand you very well , can we switch to french "	"I do not know if you can switch to french"	"BE_HAVE_MD_QUESTION"
"Do I have to pay for return shipping "	"I do not know if you have to pay for return shipping"	"DO_QUESTION"
"Where are you located on the Strip"	"I do not know where I am located on the Strip"	"WQUES"
"What is your product return policy "	"I do not know what my product return policy is"	"WQUES"
"What can I do about a package I believe was stolen from me ? I 'd like some compensation"	"I do not know what you can do about a package you believe"	"WQUES"
"What is vanillin , or artificial vanillin , and why is it used "	"I do not know why it is used"	"WQUES"
"How do I upgrade my room "	"I do not know how you upgrade your room"	"WQUES"
"Can I see the pavilion stage and hear music from the Lawn Area"	"I do not know if you can see the pavilion stage and hear music from the Lawn Area"	"BE_HAVE_MD_QUESTION"
"I 'm moving in two months , and I wanted to make sure that my mailed subscription goes to the right place . I wo n't have a US mailing address for one month , is there anything I can do to get my monthly order early "	"I do not know if there is anything you can do to get your monthly order early"	"BE_HAVE_MD_QUESTION"
"What years are available for the content "	"I do not know what years are available for the content"	"WQUES_SIMPLE"
"I lost my id cards , can i go online to get a new one , or do i have to wait for it in the mail "	"I do not know if you can go online to get a new"	"BE_HAVE_MD_QUESTION"
"Do you have places to eat , or can I bring my own food into the museum "	"I do not know if I have places to eat , or can you bring your own food into the museum"	"DO_QUESTION"
"I am interested in upgrading my membership to a higher level . How should I do this "	"I do not know how you should do this"	"WQUES"
"How do I reset my current voicemail password "	"I do not know how you reset your current voicemail password"	"WQUES"
"Is a stepparent eligible to be the caretaker for an applicant age 14-21 "	"I do not know if a stepparent eligible is to be the caretaker for an applicant age 14-21"	"BE_HAVE_MD_QUESTION"
"Can we use the shop without paying to get into the Zoo "	"I do not know if you can use the shop without paying to get into the Zoo"	"BE_HAVE_MD_QUESTION"
"If I forgot to order something this morning , can I still add the item to my order "	"I do not know if you can still add the item to your order"	"BE_HAVE_MD_QUESTION"
"How long does it take to prepare an order for 100 of these custom made signs "	"I do not know how long it takes to prepare an order for 100 of these custom"	"WQUES"
"How much does a Wag ! dog walk cost "	"I do not know how much does a Wag !"	"WQUES_SIMPLE"
"I would like to purchase an online subscription but the site says my country 's region is n't available is there anything wrong "	"I do not know how to handle 'I would like to purchase an online subscription but the site says my country 's region is n't available is there anything wrong '"	"CANONICAL_IDK"
"How do you define a family member "	"I do not know how I define a family member"	"WQUES"
"Do you use props or shills "	"I do not know if I use props or shills"	"DO_QUESTION"
"Where are the toilets located "	"I do not know where are the toilets located"	"WQUES_SIMPLE"
"How do I apply my discount at checkout "	"I do not know how you apply your discount at checkout"	"WQUES"
"I know it 's sold out elsewhere , but do you carry any of these "	"I do not know how to handle 'I know it 's sold out elsewhere , but do you carry any of these '"	"CANONICAL_IDK"
"It 's been some time since I 've received my order , can you look into the location of the package "	"I do not know if I can look into the location of the package"	"BE_HAVE_MD_QUESTION"
"Why did n't the basket I order look exactly like the one in the picture : I am noticing a lot of different brands and products "	"I do not know why the basket you order n't looked exactly like the one in the picture : you are noticing a lot of different brands and products"	"WQUES"
"Is Pacific a religious or church-related university "	"I do not know if Pacific is a religious or church-related university"	"BE_HAVE_MD_QUESTION"
"What holidays are observed at the University "	"I do not know what holidays are observed at the University"	"WQUES_SIMPLE"
"What are your busiest days "	"I do not know what my busiest days are"	"WQUES"
"What is Retro Cinema "	"I do not know what Retro Cinema is"	"WQUES"
"If it is very cold will the animals still be out and about "	"I do not know how to handle 'If it is very cold will the animals still be out and about '"	"CANONICAL_IDK"
"What Is The Membership Renewal Process "	"I do not know what Is The Membership Renewal Process"	"WQUES"
"What if the beginner class is too hard "	"I do not know what if the beginner class is too hard"	"WQUES_SIMPLE"
"What will be my monthly payment "	"I do not know what will be your monthly payment"	"WSUBJ"
"Can I book an educational programme in another language "	"I do not know if you can book an educational programme in another language"	"BE_HAVE_MD_QUESTION"
"My package was supposed to be delivered yesterday , can you track it for me "	"I do not know how to your package was supposed to be delivered"	"IMPERATIVE"
"Can you help me reset my online password so that I can log into my account on your website "	"I do not know if I can help you reset your online password so that you can log into your account on my website"	"BE_HAVE_MD_QUESTION"
"What is my password "	"I do not know what your password is"	"WQUES"
"Will I need to provide a major credit card "	"I do not know if you will need to provide a major credit card"	"BE_HAVE_MD_QUESTION"
"What is happening to the compelling reason time policy "	"I do not know what is happening to the compelling reason time policy"	"WSUBJ"
